"","date","away_team","points_away","home_team","points_home","attendance","home_win","point_difference","abs_point_dif","season","win_percentage"
"1",2016-10-25,"New York Knicks",88,"Cleveland Cavaliers",117,20562,1,29,29,"2016-17",75.5102040816327
"2",2016-10-25,"Utah Jazz",104,"Portland Trail Blazers",113,19446,1,9,9,"2016-17",58.1395348837209
"3",2016-10-25,"San Antonio Spurs",129,"Golden State Warriors",100,19596,0,-29,29,"2016-17",90
"4",2016-10-26,"Dallas Mavericks",121,"Indiana Pacers",130,17923,1,9,9,"2016-17",67.4418604651163
"5",2016-10-26,"Miami Heat",108,"Orlando Magic",96,19298,0,-12,12,"2016-17",39.0243902439024
"6",2016-10-26,"Detroit Pistons",91,"Toronto Raptors",109,19800,1,18,18,"2016-17",65.2173913043478
"7",2016-10-26,"Brooklyn Nets",117,"Boston Celtics",122,18624,1,5,5,"2016-17",68.6274509803922
"8",2016-10-26,"Charlotte Hornets",107,"Milwaukee Bucks",96,18717,0,-11,11,"2016-17",54.5454545454545
"9",2016-10-26,"Denver Nuggets",107,"New Orleans Pelicans",102,15869,0,-5,5,"2016-17",51.219512195122
"10",2016-10-26,"Minnesota Timberwolves",98,"Memphis Grizzlies",102,18119,1,4,4,"2016-17",59.0909090909091
"11",2016-10-26,"Oklahoma City Thunder",103,"Philadelphia 76ers",97,20487,0,-6,6,"2016-17",41.4634146341463
"12",2016-10-26,"Sacramento Kings",113,"Phoenix Suns",94,18055,0,-19,19,"2016-17",36.5853658536585
"13",2016-10-26,"Houston Rockets",114,"Los Angeles Lakers",120,18997,1,6,6,"2016-17",41.4634146341463
"14",2016-10-27,"Washington Wizards",99,"Atlanta Hawks",114,19049,1,15,15,"2016-17",56.8181818181818
"15",2016-10-27,"Boston Celtics",99,"Chicago Bulls",105,21501,1,6,6,"2016-17",56.8181818181818
"16",2016-10-27,"Los Angeles Clippers",114,"Portland Trail Blazers",106,19500,0,-8,8,"2016-17",58.1395348837209
"17",2016-10-27,"San Antonio Spurs",102,"Sacramento Kings",94,17608,0,-8,8,"2016-17",41.4634146341463
"18",2016-10-28,"Cleveland Cavaliers",94,"Toronto Raptors",91,19800,0,-3,3,"2016-17",65.2173913043478
"19",2016-10-28,"Indiana Pacers",94,"Brooklyn Nets",103,17732,1,9,9,"2016-17",31.7073170731707
"20",2016-10-28,"Orlando Magic",82,"Detroit Pistons",108,19122,1,26,26,"2016-17",58.5365853658537
"21",2016-10-28,"Phoenix Suns",110,"Oklahoma City Thunder",113,18203,1,3,3,"2016-17",67.4418604651163
"22",2016-10-28,"Charlotte Hornets",97,"Miami Heat",91,19600,0,-6,6,"2016-17",56.0975609756098
"23",2016-10-28,"Houston Rockets",106,"Dallas Mavericks",98,20163,0,-8,8,"2016-17",51.219512195122
"24",2016-10-28,"Los Angeles Lakers",89,"Utah Jazz",96,19911,1,7,7,"2016-17",65.2173913043478
"25",2016-10-28,"Golden State Warriors",122,"New Orleans Pelicans",114,18217,0,-8,8,"2016-17",51.219512195122
"26",2016-10-29,"Atlanta Hawks",104,"Philadelphia 76ers",72,16312,0,-32,32,"2016-17",41.4634146341463
"27",2016-10-29,"Boston Celtics",104,"Charlotte Hornets",98,18708,0,-6,6,"2016-17",53.6585365853659
"28",2016-10-29,"Orlando Magic",99,"Cleveland Cavaliers",105,20562,1,6,6,"2016-17",75.5102040816327
"29",2016-10-29,"Memphis Grizzlies",104,"New York Knicks",111,19812,1,7,7,"2016-17",46.3414634146341
"30",2016-10-29,"New Orleans Pelicans",79,"San Antonio Spurs",98,18418,1,19,19,"2016-17",73.469387755102
"31",2016-10-29,"Brooklyn Nets",108,"Milwaukee Bucks",110,12570,1,2,2,"2016-17",54.5454545454545
"32",2016-10-29,"Indiana Pacers",101,"Chicago Bulls",118,21373,1,17,17,"2016-17",56.8181818181818
"33",2016-10-29,"Portland Trail Blazers",115,"Denver Nuggets",113,18055,0,-2,2,"2016-17",53.6585365853659
"34",2016-10-29,"Minnesota Timberwolves",103,"Sacramento Kings",106,17608,1,3,3,"2016-17",41.4634146341463
"35",2016-10-30,"Utah Jazz",75,"Los Angeles Clippers",88,19060,1,13,13,"2016-17",66.6666666666667
"36",2016-10-30,"Milwaukee Bucks",83,"Detroit Pistons",98,15161,1,15,15,"2016-17",58.5365853658537
"37",2016-10-30,"San Antonio Spurs",106,"Miami Heat",99,19678,0,-7,7,"2016-17",56.0975609756098
"38",2016-10-30,"Golden State Warriors",106,"Phoenix Suns",100,17011,0,-6,6,"2016-17",36.5853658536585
"39",2016-10-30,"Los Angeles Lakers",96,"Oklahoma City Thunder",113,18203,1,17,17,"2016-17",67.4418604651163
"40",2016-10-30,"Dallas Mavericks",92,"Houston Rockets",93,18055,1,1,1,"2016-17",72.3404255319149
"41",2016-10-30,"Washington Wizards",103,"Memphis Grizzlies",112,15573,1,9,9,"2016-17",59.0909090909091
"42",2016-10-31,"Sacramento Kings",95,"Atlanta Hawks",106,12501,1,11,11,"2016-17",56.8181818181818
"43",2016-10-31,"Chicago Bulls",118,"Brooklyn Nets",88,15842,0,-30,30,"2016-17",31.7073170731707
"44",2016-10-31,"Denver Nuggets",102,"Toronto Raptors",105,19800,1,3,3,"2016-17",65.2173913043478
"45",2016-10-31,"Phoenix Suns",98,"Los Angeles Clippers",116,19060,1,18,18,"2016-17",66.6666666666667
"46",2016-11-01,"Houston Rockets",120,"Cleveland Cavaliers",128,20562,1,8,8,"2016-17",75.5102040816327
"47",2016-11-01,"Los Angeles Lakers",108,"Indiana Pacers",115,15348,1,7,7,"2016-17",67.4418604651163
"48",2016-11-01,"Orlando Magic",103,"Philadelphia 76ers",101,12529,0,-2,2,"2016-17",41.4634146341463
"49",2016-11-01,"New York Knicks",89,"Detroit Pistons",102,13087,1,13,13,"2016-17",58.5365853658537
"50",2016-11-01,"Sacramento Kings",96,"Miami Heat",108,19612,1,12,12,"2016-17",56.0975609756098
"51",2016-11-01,"Memphis Grizzlies",80,"Minnesota Timberwolves",116,14774,1,36,36,"2016-17",48.780487804878
"52",2016-11-01,"Milwaukee Bucks",117,"New Orleans Pelicans",113,15515,0,-4,4,"2016-17",51.219512195122
"53",2016-11-01,"Utah Jazz",106,"San Antonio Spurs",91,18418,0,-15,15,"2016-17",73.469387755102
"54",2016-11-01,"Golden State Warriors",127,"Portland Trail Blazers",104,19393,0,-23,23,"2016-17",58.1395348837209
"55",2016-11-02,"Philadelphia 76ers",93,"Charlotte Hornets",109,15275,1,16,16,"2016-17",53.6585365853659
"56",2016-11-02,"Toronto Raptors",113,"Washington Wizards",103,19581,0,-10,10,"2016-17",76.5957446808511
"57",2016-11-02,"Los Angeles Lakers",123,"Atlanta Hawks",116,13800,0,-7,7,"2016-17",56.8181818181818
"58",2016-11-02,"Detroit Pistons",101,"Brooklyn Nets",109,13650,1,8,8,"2016-17",31.7073170731707
"59",2016-11-02,"Houston Rockets",118,"New York Knicks",99,19812,0,-19,19,"2016-17",46.3414634146341
"60",2016-11-02,"Chicago Bulls",100,"Boston Celtics",107,18624,1,7,7,"2016-17",68.6274509803922
"61",2016-11-02,"New Orleans Pelicans",83,"Memphis Grizzlies",89,15881,1,6,6,"2016-17",59.0909090909091
"62",2016-11-02,"Dallas Mavericks",81,"Utah Jazz",97,19318,1,16,16,"2016-17",65.2173913043478
"63",2016-11-02,"Portland Trail Blazers",115,"Phoenix Suns",118,17284,1,3,3,"2016-17",36.5853658536585
"64",2016-11-02,"Oklahoma City Thunder",85,"Los Angeles Clippers",83,19060,0,-2,2,"2016-17",66.6666666666667
"65",2016-11-03,"Sacramento Kings",94,"Orlando Magic",102,17026,1,8,8,"2016-17",39.0243902439024
"66",2016-11-03,"Boston Celtics",122,"Cleveland Cavaliers",128,20562,1,6,6,"2016-17",75.5102040816327
"67",2016-11-03,"Indiana Pacers",107,"Milwaukee Bucks",125,11374,1,18,18,"2016-17",54.5454545454545
"68",2016-11-03,"Denver Nuggets",102,"Minnesota Timberwolves",99,11219,0,-3,3,"2016-17",48.780487804878
"69",2016-11-03,"Oklahoma City Thunder",96,"Golden State Warriors",122,19596,1,26,26,"2016-17",90
"70",2016-11-04,"Atlanta Hawks",92,"Washington Wizards",95,14663,1,3,3,"2016-17",76.5957446808511
"71",2016-11-04,"Charlotte Hornets",99,"Brooklyn Nets",95,15775,0,-4,4,"2016-17",31.7073170731707
"72",2016-11-04,"Miami Heat",87,"Toronto Raptors",96,19800,1,9,9,"2016-17",65.2173913043478
"73",2016-11-04,"New York Knicks",117,"Chicago Bulls",104,22376,0,-13,13,"2016-17",56.8181818181818
"74",2016-11-04,"Los Angeles Clippers",99,"Memphis Grizzlies",88,17115,0,-11,11,"2016-17",59.0909090909091
"75",2016-11-04,"Phoenix Suns",112,"New Orleans Pelicans",111,15379,0,-1,1,"2016-17",51.219512195122
"76",2016-11-04,"Portland Trail Blazers",105,"Dallas Mavericks",95,19475,0,-10,10,"2016-17",51.219512195122
"77",2016-11-04,"San Antonio Spurs",100,"Utah Jazz",86,19911,0,-14,14,"2016-17",65.2173913043478
"78",2016-11-04,"Golden State Warriors",97,"Los Angeles Lakers",117,18997,1,20,20,"2016-17",41.4634146341463
"79",2016-11-05,"Minnesota Timberwolves",92,"Oklahoma City Thunder",112,18203,1,20,20,"2016-17",67.4418604651163
"80",2016-11-05,"Denver Nuggets",86,"Detroit Pistons",103,16218,1,17,17,"2016-17",58.5365853658537
"81",2016-11-05,"Chicago Bulls",94,"Indiana Pacers",111,17020,1,17,17,"2016-17",67.4418604651163
"82",2016-11-05,"Washington Wizards",86,"Orlando Magic",88,18846,1,2,2,"2016-17",39.0243902439024
"83",2016-11-05,"Cleveland Cavaliers",102,"Philadelphia 76ers",101,20497,0,-1,1,"2016-17",41.4634146341463
"84",2016-11-05,"Houston Rockets",97,"Atlanta Hawks",112,16895,1,15,15,"2016-17",56.8181818181818
"85",2016-11-05,"Sacramento Kings",91,"Milwaukee Bucks",117,16021,1,26,26,"2016-17",54.5454545454545
"86",2016-11-05,"Los Angeles Clippers",116,"San Antonio Spurs",92,18418,0,-24,24,"2016-17",73.469387755102
"87",2016-11-06,"Utah Jazz",114,"New York Knicks",109,19812,0,-5,5,"2016-17",46.3414634146341
"88",2016-11-06,"Portland Trail Blazers",100,"Memphis Grizzlies",94,16233,0,-6,6,"2016-17",59.0909090909091
"89",2016-11-06,"Sacramento Kings",96,"Toronto Raptors",91,19800,0,-5,5,"2016-17",65.2173913043478
"90",2016-11-06,"Milwaukee Bucks",75,"Dallas Mavericks",86,19345,1,11,11,"2016-17",51.219512195122
"91",2016-11-06,"Denver Nuggets",123,"Boston Celtics",107,17452,0,-16,16,"2016-17",68.6274509803922
"92",2016-11-06,"Phoenix Suns",108,"Los Angeles Lakers",119,18997,1,11,11,"2016-17",41.4634146341463
"93",2016-11-07,"Indiana Pacers",100,"Charlotte Hornets",122,16880,1,22,22,"2016-17",53.6585365853659
"94",2016-11-07,"Utah Jazz",109,"Philadelphia 76ers",84,14168,0,-25,25,"2016-17",41.4634146341463
"95",2016-11-07,"Houston Rockets",114,"Washington Wizards",106,13173,0,-8,8,"2016-17",76.5957446808511
"96",2016-11-07,"Orlando Magic",80,"Chicago Bulls",112,21320,1,32,32,"2016-17",56.8181818181818
"97",2016-11-07,"Miami Heat",85,"Oklahoma City Thunder",97,18203,1,12,12,"2016-17",67.4418604651163
"98",2016-11-07,"New Orleans Pelicans",106,"Golden State Warriors",116,19596,1,10,10,"2016-17",90
"99",2016-11-07,"Detroit Pistons",82,"Los Angeles Clippers",114,19060,1,32,32,"2016-17",66.6666666666667
"100",2016-11-08,"Atlanta Hawks",110,"Cleveland Cavaliers",106,20562,0,-4,4,"2016-17",75.5102040816327
"101",2016-11-08,"Minnesota Timberwolves",110,"Brooklyn Nets",119,13610,1,9,9,"2016-17",31.7073170731707
"102",2016-11-08,"Denver Nuggets",107,"Memphis Grizzlies",108,15109,1,1,1,"2016-17",59.0909090909091
"103",2016-11-08,"Phoenix Suns",121,"Portland Trail Blazers",124,19239,1,3,3,"2016-17",58.1395348837209
"104",2016-11-08,"Dallas Mavericks",109,"Los Angeles Lakers",97,18997,0,-12,12,"2016-17",41.4634146341463
"105",2016-11-08,"New Orleans Pelicans",94,"Sacramento Kings",102,17608,1,8,8,"2016-17",41.4634146341463
"106",2016-11-09,"Utah Jazz",98,"Charlotte Hornets",104,15712,1,6,6,"2016-17",53.6585365853659
"107",2016-11-09,"Philadelphia 76ers",115,"Indiana Pacers",122,15360,1,7,7,"2016-17",67.4418604651163
"108",2016-11-09,"Brooklyn Nets",96,"New York Knicks",110,19812,1,14,14,"2016-17",46.3414634146341
"109",2016-11-09,"Minnesota Timberwolves",123,"Orlando Magic",107,17102,0,-16,16,"2016-17",39.0243902439024
"110",2016-11-09,"Boston Celtics",93,"Washington Wizards",118,12675,1,25,25,"2016-17",76.5957446808511
"111",2016-11-09,"Chicago Bulls",107,"Atlanta Hawks",115,16354,1,8,8,"2016-17",56.8181818181818
"112",2016-11-09,"Toronto Raptors",112,"Oklahoma City Thunder",102,18203,0,-10,10,"2016-17",67.4418604651163
"113",2016-11-09,"Detroit Pistons",100,"Phoenix Suns",107,16719,1,7,7,"2016-17",36.5853658536585
"114",2016-11-09,"Houston Rockets",101,"San Antonio Spurs",99,18418,0,-2,2,"2016-17",73.469387755102
"115",2016-11-09,"Dallas Mavericks",95,"Golden State Warriors",116,19596,1,21,21,"2016-17",90
"116",2016-11-09,"Portland Trail Blazers",80,"Los Angeles Clippers",111,19060,1,31,31,"2016-17",66.6666666666667
"117",2016-11-10,"Chicago Bulls",98,"Miami Heat",95,19600,0,-3,3,"2016-17",56.0975609756098
"118",2016-11-10,"New Orleans Pelicans",112,"Milwaukee Bucks",106,12159,0,-6,6,"2016-17",54.5454545454545
"119",2016-11-10,"Golden State Warriors",125,"Denver Nuggets",101,17569,0,-24,24,"2016-17",53.6585365853659
"120",2016-11-10,"Los Angeles Lakers",101,"Sacramento Kings",91,17608,0,-10,10,"2016-17",41.4634146341463
"121",2016-11-11,"Toronto Raptors",113,"Charlotte Hornets",111,18107,0,-2,2,"2016-17",53.6585365853659
"122",2016-11-11,"Utah Jazz",87,"Orlando Magic",74,18846,0,-13,13,"2016-17",39.0243902439024
"123",2016-11-11,"Indiana Pacers",105,"Philadelphia 76ers",109,17643,1,4,4,"2016-17",41.4634146341463
"124",2016-11-11,"Cleveland Cavaliers",105,"Washington Wizards",94,20356,0,-11,11,"2016-17",76.5957446808511
"125",2016-11-11,"New York Knicks",87,"Boston Celtics",115,18624,1,28,28,"2016-17",68.6274509803922
"126",2016-11-11,"Los Angeles Clippers",110,"Oklahoma City Thunder",108,18203,0,-2,2,"2016-17",67.4418604651163
"127",2016-11-11,"Detroit Pistons",86,"San Antonio Spurs",96,18418,1,10,10,"2016-17",73.469387755102
"128",2016-11-11,"Sacramento Kings",120,"Portland Trail Blazers",122,19918,1,2,2,"2016-17",58.1395348837209
"129",2016-11-12,"Boston Celtics",105,"Indiana Pacers",99,17923,0,-6,6,"2016-17",67.4418604651163
"130",2016-11-12,"Los Angeles Lakers",126,"New Orleans Pelicans",99,17138,0,-27,27,"2016-17",51.219512195122
"131",2016-11-12,"Philadelphia 76ers",96,"Atlanta Hawks",117,17399,1,21,21,"2016-17",56.8181818181818
"132",2016-11-12,"New York Knicks",107,"Toronto Raptors",118,19800,1,11,11,"2016-17",65.2173913043478
"133",2016-11-12,"Washington Wizards",95,"Chicago Bulls",106,21962,1,11,11,"2016-17",56.8181818181818
"134",2016-11-12,"San Antonio Spurs",106,"Houston Rockets",100,18055,0,-6,6,"2016-17",72.3404255319149
"135",2016-11-12,"Utah Jazz",102,"Miami Heat",91,19600,0,-11,11,"2016-17",56.0975609756098
"136",2016-11-12,"Los Angeles Clippers",119,"Minnesota Timberwolves",105,14494,0,-14,14,"2016-17",48.780487804878
"137",2016-11-12,"Memphis Grizzlies",96,"Milwaukee Bucks",106,14327,1,10,10,"2016-17",54.5454545454545
"138",2016-11-12,"Detroit Pistons",106,"Denver Nuggets",95,13997,0,-11,11,"2016-17",53.6585365853659
"139",2016-11-12,"Brooklyn Nets",122,"Phoenix Suns",104,17126,0,-18,18,"2016-17",36.5853658536585
"140",2016-11-13,"Charlotte Hornets",93,"Cleveland Cavaliers",100,20562,1,7,7,"2016-17",75.5102040816327
"141",2016-11-13,"Los Angeles Lakers",99,"Minnesota Timberwolves",125,14432,1,26,26,"2016-17",48.780487804878
"142",2016-11-13,"Orlando Magic",119,"Oklahoma City Thunder",117,18203,0,-2,2,"2016-17",67.4418604651163
"143",2016-11-13,"Phoenix Suns",120,"Golden State Warriors",133,19596,1,13,13,"2016-17",90
"144",2016-11-13,"Denver Nuggets",105,"Portland Trail Blazers",112,19362,1,7,7,"2016-17",58.1395348837209
"145",2016-11-14,"Orlando Magic",69,"Indiana Pacers",88,14825,1,19,19,"2016-17",67.4418604651163
"146",2016-11-14,"Oklahoma City Thunder",88,"Detroit Pistons",104,14172,1,16,16,"2016-17",58.5365853658537
"147",2016-11-14,"Dallas Mavericks",77,"New York Knicks",93,19812,1,16,16,"2016-17",46.3414634146341
"148",2016-11-14,"Philadelphia 76ers",88,"Houston Rockets",115,13183,1,27,27,"2016-17",72.3404255319149
"149",2016-11-14,"Boston Celtics",105,"New Orleans Pelicans",106,15001,1,1,1,"2016-17",51.219512195122
"150",2016-11-14,"Miami Heat",90,"San Antonio Spurs",94,18418,1,4,4,"2016-17",73.469387755102
"151",2016-11-14,"Memphis Grizzlies",102,"Utah Jazz",96,18176,0,-6,6,"2016-17",65.2173913043478
"152",2016-11-14,"Brooklyn Nets",95,"Los Angeles Clippers",127,19060,1,32,32,"2016-17",66.6666666666667
"153",2016-11-15,"Toronto Raptors",117,"Cleveland Cavaliers",121,20562,1,4,4,"2016-17",75.5102040816327
"154",2016-11-15,"Atlanta Hawks",93,"Miami Heat",90,19600,0,-3,3,"2016-17",56.0975609756098
"155",2016-11-15,"Charlotte Hornets",115,"Minnesota Timberwolves",108,10349,0,-7,7,"2016-17",48.780487804878
"156",2016-11-15,"Chicago Bulls",113,"Portland Trail Blazers",88,19393,0,-25,25,"2016-17",58.1395348837209
"157",2016-11-15,"Brooklyn Nets",118,"Los Angeles Lakers",125,18426,1,7,7,"2016-17",41.4634146341463
"158",2016-11-16,"Cleveland Cavaliers",93,"Indiana Pacers",103,17022,1,10,10,"2016-17",67.4418604651163
"159",2016-11-16,"New Orleans Pelicans",82,"Orlando Magic",89,16127,1,7,7,"2016-17",39.0243902439024
"160",2016-11-16,"Washington Wizards",102,"Philadelphia 76ers",109,14863,1,7,7,"2016-17",41.4634146341463
"161",2016-11-16,"Milwaukee Bucks",100,"Atlanta Hawks",107,14656,1,7,7,"2016-17",56.8181818181818
"162",2016-11-16,"Dallas Mavericks",83,"Boston Celtics",90,18624,1,7,7,"2016-17",68.6274509803922
"163",2016-11-16,"Detroit Pistons",102,"New York Knicks",105,19812,1,3,3,"2016-17",46.3414634146341
"164",2016-11-16,"Houston Rockets",103,"Oklahoma City Thunder",105,18203,1,2,2,"2016-17",67.4418604651163
"165",2016-11-16,"Golden State Warriors",127,"Toronto Raptors",121,21050,0,-6,6,"2016-17",65.2173913043478
"166",2016-11-16,"Phoenix Suns",104,"Denver Nuggets",120,10247,1,16,16,"2016-17",53.6585365853659
"167",2016-11-16,"Memphis Grizzlies",111,"Los Angeles Clippers",107,19060,0,-4,4,"2016-17",66.6666666666667
"168",2016-11-16,"San Antonio Spurs",110,"Sacramento Kings",105,17608,0,-5,5,"2016-17",41.4634146341463
"169",2016-11-17,"New York Knicks",112,"Washington Wizards",119,16704,1,7,7,"2016-17",76.5957446808511
"170",2016-11-17,"Milwaukee Bucks",73,"Miami Heat",96,19600,1,23,23,"2016-17",56.0975609756098
"171",2016-11-17,"Portland Trail Blazers",109,"Houston Rockets",126,15550,1,17,17,"2016-17",72.3404255319149
"172",2016-11-17,"Philadelphia 76ers",86,"Minnesota Timberwolves",110,16866,1,24,24,"2016-17",48.780487804878
"173",2016-11-17,"Chicago Bulls",85,"Utah Jazz",77,19911,0,-8,8,"2016-17",65.2173913043478
"174",2016-11-18,"Atlanta Hawks",96,"Charlotte Hornets",100,17989,1,4,4,"2016-17",53.6585365853659
"175",2016-11-18,"Phoenix Suns",116,"Indiana Pacers",96,16780,0,-20,20,"2016-17",67.4418604651163
"176",2016-11-18,"Detroit Pistons",81,"Cleveland Cavaliers",104,20562,1,23,23,"2016-17",75.5102040816327
"177",2016-11-18,"Golden State Warriors",104,"Boston Celtics",88,18624,0,-16,16,"2016-17",68.6274509803922
"178",2016-11-18,"Portland Trail Blazers",101,"New Orleans Pelicans",113,15552,1,12,12,"2016-17",51.219512195122
"179",2016-11-18,"Brooklyn Nets",105,"Oklahoma City Thunder",124,18203,1,19,19,"2016-17",67.4418604651163
"180",2016-11-18,"Memphis Grizzlies",80,"Dallas Mavericks",64,19715,0,-16,16,"2016-17",51.219512195122
"181",2016-11-18,"Toronto Raptors",113,"Denver Nuggets",111,12476,0,-2,2,"2016-17",53.6585365853659
"182",2016-11-18,"San Antonio Spurs",116,"Los Angeles Lakers",107,18997,0,-9,9,"2016-17",41.4634146341463
"183",2016-11-18,"Los Angeles Clippers",121,"Sacramento Kings",115,17608,0,-6,6,"2016-17",41.4634146341463
"184",2016-11-19,"Utah Jazz",102,"Houston Rockets",111,14760,1,9,9,"2016-17",72.3404255319149
"185",2016-11-19,"Boston Celtics",94,"Detroit Pistons",92,16107,0,-2,2,"2016-17",58.5365853658537
"186",2016-11-19,"Charlotte Hornets",116,"New Orleans Pelicans",121,15739,1,5,5,"2016-17",51.219512195122
"187",2016-11-19,"Dallas Mavericks",87,"Orlando Magic",95,18846,1,8,8,"2016-17",39.0243902439024
"188",2016-11-19,"Miami Heat",114,"Washington Wizards",111,15848,0,-3,3,"2016-17",76.5957446808511
"189",2016-11-19,"Phoenix Suns",105,"Philadelphia 76ers",120,18125,1,15,15,"2016-17",41.4634146341463
"190",2016-11-19,"Minnesota Timberwolves",71,"Memphis Grizzlies",93,17112,1,22,22,"2016-17",59.0909090909091
"191",2016-11-19,"Golden State Warriors",124,"Milwaukee Bucks",121,18717,0,-3,3,"2016-17",54.5454545454545
"192",2016-11-19,"Chicago Bulls",95,"Los Angeles Clippers",102,19060,1,7,7,"2016-17",66.6666666666667
"193",2016-11-20,"Atlanta Hawks",94,"New York Knicks",104,19812,1,10,10,"2016-17",46.3414634146341
"194",2016-11-20,"Portland Trail Blazers",129,"Brooklyn Nets",109,16608,0,-20,20,"2016-17",31.7073170731707
"195",2016-11-20,"Indiana Pacers",115,"Oklahoma City Thunder",111,18203,0,-4,4,"2016-17",67.4418604651163
"196",2016-11-20,"Utah Jazz",91,"Denver Nuggets",105,12565,1,14,14,"2016-17",53.6585365853659
"197",2016-11-20,"Toronto Raptors",99,"Sacramento Kings",102,17608,1,3,3,"2016-17",41.4634146341463
"198",2016-11-20,"Chicago Bulls",118,"Los Angeles Lakers",110,18997,0,-8,8,"2016-17",41.4634146341463
"199",2016-11-21,"Memphis Grizzlies",105,"Charlotte Hornets",90,14181,0,-15,15,"2016-17",53.6585365853659
"200",2016-11-21,"Golden State Warriors",120,"Indiana Pacers",83,17923,0,-37,37,"2016-17",67.4418604651163
"201",2016-11-21,"Miami Heat",94,"Philadelphia 76ers",101,16477,1,7,7,"2016-17",41.4634146341463
"202",2016-11-21,"Phoenix Suns",101,"Washington Wizards",106,12790,1,5,5,"2016-17",76.5957446808511
"203",2016-11-21,"Houston Rockets",99,"Detroit Pistons",96,13632,0,-3,3,"2016-17",58.5365853658537
"204",2016-11-21,"Orlando Magic",89,"Milwaukee Bucks",93,12306,1,4,4,"2016-17",54.5454545454545
"205",2016-11-21,"Boston Celtics",99,"Minnesota Timberwolves",93,13167,0,-6,6,"2016-17",48.780487804878
"206",2016-11-21,"Dallas Mavericks",91,"San Antonio Spurs",96,18418,1,5,5,"2016-17",73.469387755102
"207",2016-11-21,"Toronto Raptors",115,"Los Angeles Clippers",123,19060,1,8,8,"2016-17",66.6666666666667
"208",2016-11-22,"New Orleans Pelicans",112,"Atlanta Hawks",94,19120,0,-18,18,"2016-17",56.8181818181818
"209",2016-11-22,"Portland Trail Blazers",103,"New York Knicks",107,19812,1,4,4,"2016-17",46.3414634146341
"210",2016-11-22,"Chicago Bulls",107,"Denver Nuggets",110,14328,1,3,3,"2016-17",53.6585365853659
"211",2016-11-22,"Oklahoma City Thunder",109,"Los Angeles Lakers",111,18997,1,2,2,"2016-17",41.4634146341463
"212",2016-11-23,"San Antonio Spurs",119,"Charlotte Hornets",114,18515,0,-5,5,"2016-17",53.6585365853659
"213",2016-11-23,"Portland Trail Blazers",125,"Cleveland Cavaliers",137,20562,1,12,12,"2016-17",75.5102040816327
"214",2016-11-23,"Atlanta Hawks",96,"Indiana Pacers",85,16032,0,-11,11,"2016-17",67.4418604651163
"215",2016-11-23,"Phoenix Suns",92,"Orlando Magic",87,17069,0,-5,5,"2016-17",39.0243902439024
"216",2016-11-23,"Memphis Grizzlies",104,"Philadelphia 76ers",99,15880,0,-5,5,"2016-17",41.4634146341463
"217",2016-11-23,"Boston Celtics",111,"Brooklyn Nets",92,16210,0,-19,19,"2016-17",31.7073170731707
"218",2016-11-23,"Miami Heat",84,"Detroit Pistons",107,14520,1,23,23,"2016-17",58.5365853658537
"219",2016-11-23,"Toronto Raptors",115,"Houston Rockets",102,18055,0,-13,13,"2016-17",72.3404255319149
"220",2016-11-23,"Los Angeles Clippers",124,"Dallas Mavericks",104,20042,0,-20,20,"2016-17",51.219512195122
"221",2016-11-23,"Denver Nuggets",83,"Utah Jazz",108,19229,1,25,25,"2016-17",65.2173913043478
"222",2016-11-23,"Minnesota Timberwolves",96,"New Orleans Pelicans",117,15555,1,21,21,"2016-17",51.219512195122
"223",2016-11-23,"Los Angeles Lakers",106,"Golden State Warriors",149,19596,1,43,43,"2016-17",90
"224",2016-11-23,"Oklahoma City Thunder",101,"Sacramento Kings",116,17608,1,15,15,"2016-17",41.4634146341463
"225",2016-11-25,"San Antonio Spurs",109,"Boston Celtics",103,18624,0,-6,6,"2016-17",68.6274509803922
"226",2016-11-25,"Washington Wizards",94,"Orlando Magic",91,17103,0,-3,3,"2016-17",39.0243902439024
"227",2016-11-25,"Dallas Mavericks",90,"Cleveland Cavaliers",128,20562,1,38,38,"2016-17",75.5102040816327
"228",2016-11-25,"Los Angeles Clippers",97,"Detroit Pistons",108,17023,1,11,11,"2016-17",58.5365853658537
"229",2016-11-25,"Charlotte Hornets",111,"New York Knicks",113,19812,1,2,2,"2016-17",46.3414634146341
"230",2016-11-25,"Chicago Bulls",105,"Philadelphia 76ers",89,18234,0,-16,16,"2016-17",41.4634146341463
"231",2016-11-25,"Brooklyn Nets",97,"Indiana Pacers",118,16083,1,21,21,"2016-17",67.4418604651163
"232",2016-11-25,"Miami Heat",90,"Memphis Grizzlies",81,17222,0,-9,9,"2016-17",59.0909090909091
"233",2016-11-25,"Toronto Raptors",105,"Milwaukee Bucks",99,16223,0,-6,6,"2016-17",54.5454545454545
"234",2016-11-25,"Atlanta Hawks",68,"Utah Jazz",95,19911,1,27,27,"2016-17",65.2173913043478
"235",2016-11-25,"Oklahoma City Thunder",132,"Denver Nuggets",129,14327,0,-3,3,"2016-17",53.6585365853659
"236",2016-11-25,"Minnesota Timberwolves",98,"Phoenix Suns",85,16728,0,-13,13,"2016-17",36.5853658536585
"237",2016-11-25,"New Orleans Pelicans",104,"Portland Trail Blazers",119,19393,1,15,15,"2016-17",58.1395348837209
"238",2016-11-25,"Golden State Warriors",109,"Los Angeles Lakers",85,18997,0,-24,24,"2016-17",41.4634146341463
"239",2016-11-25,"Houston Rockets",117,"Sacramento Kings",104,17608,0,-13,13,"2016-17",41.4634146341463
"240",2016-11-26,"New York Knicks",102,"Charlotte Hornets",107,19195,1,5,5,"2016-17",53.6585365853659
"241",2016-11-26,"San Antonio Spurs",112,"Washington Wizards",100,17066,0,-12,12,"2016-17",76.5957446808511
"242",2016-11-26,"Memphis Grizzlies",110,"Miami Heat",107,19600,0,-3,3,"2016-17",56.0975609756098
"243",2016-11-26,"Detroit Pistons",88,"Oklahoma City Thunder",106,18203,1,18,18,"2016-17",67.4418604651163
"244",2016-11-26,"Minnesota Timberwolves",102,"Golden State Warriors",115,19596,1,13,13,"2016-17",90
"245",2016-11-27,"Cleveland Cavaliers",112,"Philadelphia 76ers",108,19311,0,-4,4,"2016-17",41.4634146341463
"246",2016-11-27,"Denver Nuggets",120,"Phoenix Suns",114,15365,0,-6,6,"2016-17",36.5853658536585
"247",2016-11-27,"Sacramento Kings",122,"Brooklyn Nets",105,13646,0,-17,17,"2016-17",31.7073170731707
"248",2016-11-27,"Los Angeles Clippers",70,"Indiana Pacers",91,15572,1,21,21,"2016-17",67.4418604651163
"249",2016-11-27,"Milwaukee Bucks",104,"Orlando Magic",96,16521,0,-8,8,"2016-17",39.0243902439024
"250",2016-11-27,"New Orleans Pelicans",81,"Dallas Mavericks",91,19302,1,10,10,"2016-17",51.219512195122
"251",2016-11-27,"Houston Rockets",130,"Portland Trail Blazers",114,19393,0,-16,16,"2016-17",58.1395348837209
"252",2016-11-27,"Atlanta Hawks",94,"Los Angeles Lakers",109,18997,1,15,15,"2016-17",41.4634146341463
"253",2016-11-28,"Sacramento Kings",95,"Washington Wizards",101,12571,1,6,6,"2016-17",76.5957446808511
"254",2016-11-28,"Boston Celtics",112,"Miami Heat",104,19600,0,-8,8,"2016-17",56.0975609756098
"255",2016-11-28,"Oklahoma City Thunder",112,"New York Knicks",103,19812,0,-9,9,"2016-17",46.3414634146341
"256",2016-11-28,"Philadelphia 76ers",95,"Toronto Raptors",122,19800,1,27,27,"2016-17",65.2173913043478
"257",2016-11-28,"Charlotte Hornets",104,"Memphis Grizzlies",85,13143,0,-19,19,"2016-17",59.0909090909091
"258",2016-11-28,"Utah Jazz",112,"Minnesota Timberwolves",103,9384,0,-9,9,"2016-17",48.780487804878
"259",2016-11-28,"Atlanta Hawks",100,"Golden State Warriors",105,19596,1,5,5,"2016-17",90
"260",2016-11-29,"Detroit Pistons",112,"Charlotte Hornets",89,14266,0,-23,23,"2016-17",53.6585365853659
"261",2016-11-29,"Los Angeles Clippers",122,"Brooklyn Nets",127,15681,1,5,5,"2016-17",31.7073170731707
"262",2016-11-29,"Cleveland Cavaliers",101,"Milwaukee Bucks",118,16559,1,17,17,"2016-17",54.5454545454545
"263",2016-11-29,"Los Angeles Lakers",88,"New Orleans Pelicans",105,14024,1,17,17,"2016-17",51.219512195122
"264",2016-11-29,"Orlando Magic",95,"San Antonio Spurs",83,18418,0,-12,12,"2016-17",73.469387755102
"265",2016-11-29,"Houston Rockets",101,"Utah Jazz",120,19911,1,19,19,"2016-17",65.2173913043478
"266",2016-11-30,"Detroit Pistons",121,"Boston Celtics",114,17338,0,-7,7,"2016-17",68.6274509803922
"267",2016-11-30,"Memphis Grizzlies",105,"Toronto Raptors",120,19800,1,15,15,"2016-17",65.2173913043478
"268",2016-11-30,"Los Angeles Lakers",96,"Chicago Bulls",90,21773,0,-6,6,"2016-17",56.8181818181818
"269",2016-11-30,"New York Knicks",106,"Minnesota Timberwolves",104,13987,0,-2,2,"2016-17",48.780487804878
"270",2016-11-30,"Washington Wizards",115,"Oklahoma City Thunder",126,18203,1,11,11,"2016-17",67.4418604651163
"271",2016-11-30,"San Antonio Spurs",94,"Dallas Mavericks",87,19245,0,-7,7,"2016-17",51.219512195122
"272",2016-11-30,"Miami Heat",106,"Denver Nuggets",98,11471,0,-8,8,"2016-17",53.6585365853659
"273",2016-11-30,"Atlanta Hawks",107,"Phoenix Suns",109,15909,1,2,2,"2016-17",36.5853658536585
"274",2016-11-30,"Indiana Pacers",109,"Portland Trail Blazers",131,19107,1,22,22,"2016-17",58.1395348837209
"275",2016-12-01,"Dallas Mavericks",87,"Charlotte Hornets",97,14471,1,10,10,"2016-17",53.6585365853659
"276",2016-12-01,"Milwaukee Bucks",111,"Brooklyn Nets",93,12675,0,-18,18,"2016-17",31.7073170731707
"277",2016-12-01,"Los Angeles Clippers",113,"Cleveland Cavaliers",94,20562,0,-19,19,"2016-17",75.5102040816327
"278",2016-12-01,"Orlando Magic",94,"Memphis Grizzlies",95,13344,1,1,1,"2016-17",59.0909090909091
"279",2016-12-01,"Miami Heat",111,"Utah Jazz",110,19073,0,-1,1,"2016-17",65.2173913043478
"280",2016-12-01,"Houston Rockets",132,"Golden State Warriors",127,19596,0,-5,5,"2016-17",90
"281",2016-12-02,"Orlando Magic",105,"Philadelphia 76ers",88,13711,0,-17,17,"2016-17",41.4634146341463
"282",2016-12-02,"Sacramento Kings",92,"Boston Celtics",97,18624,1,5,5,"2016-17",68.6274509803922
"283",2016-12-02,"Minnesota Timberwolves",114,"New York Knicks",118,19812,1,4,4,"2016-17",46.3414634146341
"284",2016-12-02,"Los Angeles Lakers",80,"Toronto Raptors",113,19800,1,33,33,"2016-17",65.2173913043478
"285",2016-12-02,"Detroit Pistons",121,"Atlanta Hawks",85,15500,0,-36,36,"2016-17",56.8181818181818
"286",2016-12-02,"Cleveland Cavaliers",105,"Chicago Bulls",111,21775,1,6,6,"2016-17",56.8181818181818
"287",2016-12-02,"Los Angeles Clippers",114,"New Orleans Pelicans",96,16538,0,-18,18,"2016-17",51.219512195122
"288",2016-12-02,"Washington Wizards",105,"San Antonio Spurs",107,18418,1,2,2,"2016-17",73.469387755102
"289",2016-12-02,"Houston Rockets",128,"Denver Nuggets",110,15549,0,-18,18,"2016-17",53.6585365853659
"290",2016-12-03,"Brooklyn Nets",103,"Milwaukee Bucks",112,15565,1,9,9,"2016-17",54.5454545454545
"291",2016-12-03,"Minnesota Timberwolves",125,"Charlotte Hornets",120,16982,0,-5,5,"2016-17",53.6585365853659
"292",2016-12-03,"Boston Celtics",107,"Philadelphia 76ers",106,17063,0,-1,1,"2016-17",41.4634146341463
"293",2016-12-03,"Atlanta Hawks",84,"Toronto Raptors",128,19800,1,44,44,"2016-17",65.2173913043478
"294",2016-12-03,"Los Angeles Lakers",100,"Memphis Grizzlies",103,17017,1,3,3,"2016-17",59.0909090909091
"295",2016-12-03,"Chicago Bulls",82,"Dallas Mavericks",107,19857,1,25,25,"2016-17",51.219512195122
"296",2016-12-03,"Denver Nuggets",98,"Utah Jazz",105,19911,1,7,7,"2016-17",65.2173913043478
"297",2016-12-03,"Miami Heat",92,"Portland Trail Blazers",99,19393,1,7,7,"2016-17",58.1395348837209
"298",2016-12-03,"Phoenix Suns",109,"Golden State Warriors",138,19596,1,29,29,"2016-17",90
"299",2016-12-04,"Orlando Magic",98,"Detroit Pistons",92,15206,0,-6,6,"2016-17",58.5365853658537
"300",2016-12-04,"New Orleans Pelicans",92,"Oklahoma City Thunder",101,18203,1,9,9,"2016-17",67.4418604651163
"301",2016-12-04,"Sacramento Kings",98,"New York Knicks",106,19812,1,8,8,"2016-17",46.3414634146341
"302",2016-12-04,"Indiana Pacers",111,"Los Angeles Clippers",102,19060,0,-9,9,"2016-17",66.6666666666667
"303",2016-12-05,"Denver Nuggets",106,"Philadelphia 76ers",98,11815,0,-8,8,"2016-17",41.4634146341463
"304",2016-12-05,"Oklahoma City Thunder",102,"Atlanta Hawks",99,14654,0,-3,3,"2016-17",56.8181818181818
"305",2016-12-05,"Washington Wizards",118,"Brooklyn Nets",113,12529,0,-5,5,"2016-17",31.7073170731707
"306",2016-12-05,"Cleveland Cavaliers",116,"Toronto Raptors",112,19800,0,-4,4,"2016-17",65.2173913043478
"307",2016-12-05,"Portland Trail Blazers",112,"Chicago Bulls",110,21351,0,-2,2,"2016-17",56.8181818181818
"308",2016-12-05,"Boston Celtics",106,"Houston Rockets",107,15730,1,1,1,"2016-17",72.3404255319149
"309",2016-12-05,"San Antonio Spurs",97,"Milwaukee Bucks",96,14256,0,-1,1,"2016-17",54.5454545454545
"310",2016-12-05,"Memphis Grizzlies",110,"New Orleans Pelicans",108,13795,0,-2,2,"2016-17",51.219512195122
"311",2016-12-05,"Charlotte Hornets",109,"Dallas Mavericks",101,19228,0,-8,8,"2016-17",51.219512195122
"312",2016-12-05,"Indiana Pacers",106,"Golden State Warriors",142,19596,1,36,36,"2016-17",90
"313",2016-12-05,"Utah Jazz",107,"Los Angeles Lakers",101,18279,0,-6,6,"2016-17",41.4634146341463
"314",2016-12-06,"Orlando Magic",124,"Washington Wizards",116,12116,0,-8,8,"2016-17",76.5957446808511
"315",2016-12-06,"Chicago Bulls",91,"Detroit Pistons",102,14305,1,11,11,"2016-17",58.5365853658537
"316",2016-12-06,"New York Knicks",114,"Miami Heat",103,19610,0,-11,11,"2016-17",56.0975609756098
"317",2016-12-06,"Philadelphia 76ers",91,"Memphis Grizzlies",96,13521,1,5,5,"2016-17",59.0909090909091
"318",2016-12-06,"San Antonio Spurs",105,"Minnesota Timberwolves",91,12585,0,-14,14,"2016-17",48.780487804878
"319",2016-12-06,"Phoenix Suns",105,"Utah Jazz",112,18997,1,7,7,"2016-17",65.2173913043478
"320",2016-12-07,"Detroit Pistons",77,"Charlotte Hornets",87,15141,1,10,10,"2016-17",53.6585365853659
"321",2016-12-07,"Boston Celtics",117,"Orlando Magic",87,17009,0,-30,30,"2016-17",39.0243902439024
"322",2016-12-07,"Miami Heat",95,"Atlanta Hawks",103,11326,1,8,8,"2016-17",56.8181818181818
"323",2016-12-07,"Denver Nuggets",111,"Brooklyn Nets",116,14159,1,5,5,"2016-17",31.7073170731707
"324",2016-12-07,"Los Angeles Lakers",95,"Houston Rockets",134,16141,1,39,39,"2016-17",72.3404255319149
"325",2016-12-07,"Portland Trail Blazers",107,"Milwaukee Bucks",115,14033,1,8,8,"2016-17",54.5454545454545
"326",2016-12-07,"Cleveland Cavaliers",126,"New York Knicks",94,19812,0,-32,32,"2016-17",46.3414634146341
"327",2016-12-07,"Sacramento Kings",120,"Dallas Mavericks",89,19711,0,-31,31,"2016-17",51.219512195122
"328",2016-12-07,"Indiana Pacers",109,"Phoenix Suns",94,17452,0,-15,15,"2016-17",36.5853658536585
"329",2016-12-07,"Golden State Warriors",115,"Los Angeles Clippers",98,19239,0,-17,17,"2016-17",66.6666666666667
"330",2016-12-08,"Minnesota Timberwolves",110,"Toronto Raptors",124,19800,1,14,14,"2016-17",65.2173913043478
"331",2016-12-08,"Denver Nuggets",85,"Washington Wizards",92,12645,1,7,7,"2016-17",76.5957446808511
"332",2016-12-08,"Portland Trail Blazers",86,"Memphis Grizzlies",88,14317,1,2,2,"2016-17",59.0909090909091
"333",2016-12-08,"Philadelphia 76ers",99,"New Orleans Pelicans",88,14158,0,-11,11,"2016-17",51.219512195122
"334",2016-12-08,"Golden State Warriors",106,"Utah Jazz",99,19911,0,-7,7,"2016-17",65.2173913043478
"335",2016-12-08,"San Antonio Spurs",91,"Chicago Bulls",95,21489,1,4,4,"2016-17",56.8181818181818
"336",2016-12-09,"Orlando Magic",88,"Charlotte Hornets",109,15707,1,21,21,"2016-17",53.6585365853659
"337",2016-12-09,"Toronto Raptors",101,"Boston Celtics",94,18624,0,-7,7,"2016-17",68.6274509803922
"338",2016-12-09,"Miami Heat",84,"Cleveland Cavaliers",114,20562,1,30,30,"2016-17",75.5102040816327
"339",2016-12-09,"Atlanta Hawks",114,"Milwaukee Bucks",110,16289,0,-4,4,"2016-17",54.5454545454545
"340",2016-12-09,"Detroit Pistons",117,"Minnesota Timberwolves",90,14109,0,-27,27,"2016-17",48.780487804878
"341",2016-12-09,"Houston Rockets",102,"Oklahoma City Thunder",99,18203,0,-3,3,"2016-17",67.4418604651163
"342",2016-12-09,"Indiana Pacers",103,"Dallas Mavericks",111,19486,1,8,8,"2016-17",51.219512195122
"343",2016-12-09,"Phoenix Suns",119,"Los Angeles Lakers",115,18997,0,-4,4,"2016-17",41.4634146341463
"344",2016-12-09,"New York Knicks",103,"Sacramento Kings",100,17608,0,-3,3,"2016-17",41.4634146341463
"345",2016-12-10,"Portland Trail Blazers",111,"Indiana Pacers",118,16211,1,7,7,"2016-17",67.4418604651163
"346",2016-12-10,"Denver Nuggets",121,"Orlando Magic",113,17010,0,-8,8,"2016-17",39.0243902439024
"347",2016-12-10,"Milwaukee Bucks",105,"Washington Wizards",110,14816,1,5,5,"2016-17",76.5957446808511
"348",2016-12-10,"Charlotte Hornets",105,"Cleveland Cavaliers",116,20562,1,11,11,"2016-17",75.5102040816327
"349",2016-12-10,"Miami Heat",100,"Chicago Bulls",105,21450,1,5,5,"2016-17",56.8181818181818
"350",2016-12-10,"Dallas Mavericks",87,"Houston Rockets",109,15761,1,22,22,"2016-17",72.3404255319149
"351",2016-12-10,"Golden State Warriors",89,"Memphis Grizzlies",110,18119,1,21,21,"2016-17",59.0909090909091
"352",2016-12-10,"Brooklyn Nets",101,"San Antonio Spurs",130,18418,1,29,29,"2016-17",73.469387755102
"353",2016-12-10,"Sacramento Kings",84,"Utah Jazz",104,19331,1,20,20,"2016-17",65.2173913043478
"354",2016-12-10,"New Orleans Pelicans",105,"Los Angeles Clippers",133,19060,1,28,28,"2016-17",66.6666666666667
"355",2016-12-11,"Philadelphia 76ers",97,"Detroit Pistons",79,7244,0,-18,18,"2016-17",58.5365853658537
"356",2016-12-11,"Golden State Warriors",116,"Minnesota Timberwolves",108,18452,0,-8,8,"2016-17",48.780487804878
"357",2016-12-11,"Boston Celtics",96,"Oklahoma City Thunder",99,18203,1,3,3,"2016-17",67.4418604651163
"358",2016-12-11,"New Orleans Pelicans",120,"Phoenix Suns",119,16949,0,-1,1,"2016-17",36.5853658536585
"359",2016-12-11,"New York Knicks",118,"Los Angeles Lakers",112,18997,0,-6,6,"2016-17",41.4634146341463
"360",2016-12-12,"Charlotte Hornets",94,"Indiana Pacers",110,14138,1,16,16,"2016-17",67.4418604651163
"361",2016-12-12,"Washington Wizards",101,"Miami Heat",112,19600,1,11,11,"2016-17",56.0975609756098
"362",2016-12-12,"Milwaukee Bucks",100,"Toronto Raptors",122,19800,1,22,22,"2016-17",65.2173913043478
"363",2016-12-12,"Brooklyn Nets",118,"Houston Rockets",122,13619,1,4,4,"2016-17",72.3404255319149
"364",2016-12-12,"Denver Nuggets",92,"Dallas Mavericks",112,19425,1,20,20,"2016-17",51.219512195122
"365",2016-12-12,"Portland Trail Blazers",120,"Los Angeles Clippers",121,19060,1,1,1,"2016-17",66.6666666666667
"366",2016-12-12,"Los Angeles Lakers",92,"Sacramento Kings",116,17608,1,24,24,"2016-17",41.4634146341463
"367",2016-12-13,"Memphis Grizzlies",86,"Cleveland Cavaliers",103,20562,1,17,17,"2016-17",75.5102040816327
"368",2016-12-13,"Orlando Magic",131,"Atlanta Hawks",120,13585,0,-11,11,"2016-17",56.8181818181818
"369",2016-12-13,"Minnesota Timberwolves",99,"Chicago Bulls",94,21146,0,-5,5,"2016-17",56.8181818181818
"370",2016-12-13,"Golden State Warriors",113,"New Orleans Pelicans",109,17789,0,-4,4,"2016-17",51.219512195122
"371",2016-12-13,"New York Knicks",111,"Phoenix Suns",113,16429,1,2,2,"2016-17",36.5853658536585
"372",2016-12-13,"Oklahoma City Thunder",95,"Portland Trail Blazers",114,19505,1,19,19,"2016-17",58.1395348837209
"373",2016-12-14,"Indiana Pacers",89,"Miami Heat",95,19600,1,6,6,"2016-17",56.0975609756098
"374",2016-12-14,"Los Angeles Clippers",113,"Orlando Magic",108,18846,0,-5,5,"2016-17",39.0243902439024
"375",2016-12-14,"Toronto Raptors",123,"Philadelphia 76ers",114,16192,0,-9,9,"2016-17",41.4634146341463
"376",2016-12-14,"Charlotte Hornets",106,"Washington Wizards",109,13447,1,3,3,"2016-17",76.5957446808511
"377",2016-12-14,"Los Angeles Lakers",97,"Brooklyn Nets",107,17732,1,10,10,"2016-17",31.7073170731707
"378",2016-12-14,"Sacramento Kings",98,"Houston Rockets",132,15039,1,34,34,"2016-17",72.3404255319149
"379",2016-12-14,"Cleveland Cavaliers",85,"Memphis Grizzlies",93,17449,1,8,8,"2016-17",59.0909090909091
"380",2016-12-14,"Detroit Pistons",95,"Dallas Mavericks",85,19687,0,-10,10,"2016-17",51.219512195122
"381",2016-12-14,"Oklahoma City Thunder",89,"Utah Jazz",109,19911,1,20,20,"2016-17",65.2173913043478
"382",2016-12-14,"Boston Celtics",101,"San Antonio Spurs",108,18418,1,7,7,"2016-17",73.469387755102
"383",2016-12-15,"Chicago Bulls",97,"Milwaukee Bucks",108,16704,1,11,11,"2016-17",54.5454545454545
"384",2016-12-15,"Indiana Pacers",95,"New Orleans Pelicans",102,15472,1,7,7,"2016-17",51.219512195122
"385",2016-12-15,"Portland Trail Blazers",120,"Denver Nuggets",132,10022,1,12,12,"2016-17",53.6585365853659
"386",2016-12-15,"San Antonio Spurs",107,"Phoenix Suns",92,17165,0,-15,15,"2016-17",36.5853658536585
"387",2016-12-15,"New York Knicks",90,"Golden State Warriors",103,19596,1,13,13,"2016-17",90
"388",2016-12-16,"Brooklyn Nets",111,"Orlando Magic",118,17668,1,7,7,"2016-17",39.0243902439024
"389",2016-12-16,"Detroit Pistons",108,"Washington Wizards",122,15573,1,14,14,"2016-17",76.5957446808511
"390",2016-12-16,"Charlotte Hornets",88,"Boston Celtics",96,18624,1,8,8,"2016-17",68.6274509803922
"391",2016-12-16,"Atlanta Hawks",125,"Toronto Raptors",121,19800,0,-4,4,"2016-17",65.2173913043478
"392",2016-12-16,"Milwaukee Bucks",95,"Chicago Bulls",69,21324,0,-26,26,"2016-17",56.8181818181818
"393",2016-12-16,"New Orleans Pelicans",100,"Houston Rockets",122,16728,1,22,22,"2016-17",72.3404255319149
"394",2016-12-16,"Sacramento Kings",96,"Memphis Grizzlies",92,15987,0,-4,4,"2016-17",59.0909090909091
"395",2016-12-16,"Los Angeles Clippers",102,"Miami Heat",98,19600,0,-4,4,"2016-17",56.0975609756098
"396",2016-12-16,"Los Angeles Lakers",100,"Philadelphia 76ers",89,20491,0,-11,11,"2016-17",41.4634146341463
"397",2016-12-16,"Dallas Mavericks",100,"Utah Jazz",103,18721,1,3,3,"2016-17",65.2173913043478
"398",2016-12-17,"Phoenix Suns",101,"Oklahoma City Thunder",114,18203,1,13,13,"2016-17",67.4418604651163
"399",2016-12-17,"Indiana Pacers",105,"Detroit Pistons",90,15231,0,-15,15,"2016-17",58.5365853658537
"400",2016-12-17,"Charlotte Hornets",107,"Atlanta Hawks",99,17918,0,-8,8,"2016-17",56.8181818181818
"401",2016-12-17,"Los Angeles Lakers",108,"Cleveland Cavaliers",119,20562,1,11,11,"2016-17",75.5102040816327
"402",2016-12-17,"Houston Rockets",111,"Minnesota Timberwolves",109,14689,0,-2,2,"2016-17",48.780487804878
"403",2016-12-17,"New York Knicks",114,"Denver Nuggets",127,12042,1,13,13,"2016-17",53.6585365853659
"404",2016-12-17,"Portland Trail Blazers",90,"Golden State Warriors",135,19596,1,45,45,"2016-17",90
"405",2016-12-18,"Los Angeles Clippers",110,"Washington Wizards",117,17380,1,7,7,"2016-17",76.5957446808511
"406",2016-12-18,"Sacramento Kings",79,"Dallas Mavericks",99,19504,1,20,20,"2016-17",51.219512195122
"407",2016-12-18,"Utah Jazz",82,"Memphis Grizzlies",73,15862,0,-9,9,"2016-17",59.0909090909091
"408",2016-12-18,"Boston Celtics",105,"Miami Heat",95,19600,0,-10,10,"2016-17",56.0975609756098
"409",2016-12-18,"Toronto Raptors",109,"Orlando Magic",79,17251,0,-30,30,"2016-17",39.0243902439024
"410",2016-12-18,"Brooklyn Nets",107,"Philadelphia 76ers",108,16460,1,1,1,"2016-17",41.4634146341463
"411",2016-12-18,"New Orleans Pelicans",100,"San Antonio Spurs",113,18615,1,13,13,"2016-17",73.469387755102
"412",2016-12-19,"Washington Wizards",105,"Indiana Pacers",107,17686,1,2,2,"2016-17",67.4418604651163
"413",2016-12-19,"Detroit Pistons",82,"Chicago Bulls",113,21400,1,31,31,"2016-17",56.8181818181818
"414",2016-12-19,"Phoenix Suns",108,"Minnesota Timberwolves",115,12008,1,7,7,"2016-17",48.780487804878
"415",2016-12-19,"Atlanta Hawks",110,"Oklahoma City Thunder",108,18203,0,-2,2,"2016-17",67.4418604651163
"416",2016-12-19,"Dallas Mavericks",107,"Denver Nuggets",117,12581,1,10,10,"2016-17",53.6585365853659
"417",2016-12-20,"Los Angeles Lakers",113,"Charlotte Hornets",117,19093,1,4,4,"2016-17",53.6585365853659
"418",2016-12-20,"New Orleans Pelicans",108,"Philadelphia 76ers",93,16322,0,-15,15,"2016-17",41.4634146341463
"419",2016-12-20,"Orlando Magic",136,"Miami Heat",130,19600,0,-6,6,"2016-17",56.0975609756098
"420",2016-12-20,"Indiana Pacers",111,"New York Knicks",118,19812,1,7,7,"2016-17",46.3414634146341
"421",2016-12-20,"Brooklyn Nets",104,"Toronto Raptors",116,19800,1,12,12,"2016-17",65.2173913043478
"422",2016-12-20,"San Antonio Spurs",102,"Houston Rockets",100,18055,0,-2,2,"2016-17",72.3404255319149
"423",2016-12-20,"Boston Celtics",112,"Memphis Grizzlies",109,16519,0,-3,3,"2016-17",59.0909090909091
"424",2016-12-20,"Cleveland Cavaliers",114,"Milwaukee Bucks",108,17053,0,-6,6,"2016-17",54.5454545454545
"425",2016-12-20,"Utah Jazz",74,"Golden State Warriors",104,19596,1,30,30,"2016-17",90
"426",2016-12-20,"Denver Nuggets",102,"Los Angeles Clippers",119,19060,1,17,17,"2016-17",66.6666666666667
"427",2016-12-20,"Portland Trail Blazers",121,"Sacramento Kings",126,17608,1,5,5,"2016-17",41.4634146341463
"428",2016-12-21,"Milwaukee Bucks",102,"Cleveland Cavaliers",113,20562,1,11,11,"2016-17",75.5102040816327
"429",2016-12-21,"Minnesota Timberwolves",92,"Atlanta Hawks",84,17578,0,-8,8,"2016-17",56.8181818181818
"430",2016-12-21,"Memphis Grizzlies",98,"Detroit Pistons",86,16033,0,-12,12,"2016-17",58.5365853658537
"431",2016-12-21,"Washington Wizards",107,"Chicago Bulls",97,21358,0,-10,10,"2016-17",56.8181818181818
"432",2016-12-21,"Oklahoma City Thunder",121,"New Orleans Pelicans",110,16375,0,-11,11,"2016-17",51.219512195122
"433",2016-12-21,"Houston Rockets",125,"Phoenix Suns",111,18055,0,-14,14,"2016-17",36.5853658536585
"434",2016-12-21,"Sacramento Kings",94,"Utah Jazz",93,19195,0,-1,1,"2016-17",65.2173913043478
"435",2016-12-21,"Dallas Mavericks",96,"Portland Trail Blazers",95,19393,0,-1,1,"2016-17",58.1395348837209
"436",2016-12-22,"Boston Celtics",109,"Indiana Pacers",102,17577,0,-7,7,"2016-17",67.4418604651163
"437",2016-12-22,"Golden State Warriors",117,"Brooklyn Nets",101,17732,0,-16,16,"2016-17",31.7073170731707
"438",2016-12-22,"Orlando Magic",95,"New York Knicks",106,19812,1,11,11,"2016-17",46.3414634146341
"439",2016-12-22,"Los Angeles Lakers",107,"Miami Heat",115,19712,1,8,8,"2016-17",56.0975609756098
"440",2016-12-22,"San Antonio Spurs",101,"Los Angeles Clippers",106,19060,1,5,5,"2016-17",66.6666666666667
"441",2016-12-23,"Chicago Bulls",91,"Charlotte Hornets",103,19249,1,12,12,"2016-17",53.6585365853659
"442",2016-12-23,"Los Angeles Lakers",90,"Orlando Magic",109,18846,1,19,19,"2016-17",39.0243902439024
"443",2016-12-23,"Oklahoma City Thunder",117,"Boston Celtics",112,18624,0,-5,5,"2016-17",68.6274509803922
"444",2016-12-23,"Brooklyn Nets",99,"Cleveland Cavaliers",119,20562,1,20,20,"2016-17",75.5102040816327
"445",2016-12-23,"Golden State Warriors",119,"Detroit Pistons",113,21012,0,-6,6,"2016-17",58.5365853658537
"446",2016-12-23,"Houston Rockets",109,"Memphis Grizzlies",115,17454,1,6,6,"2016-17",59.0909090909091
"447",2016-12-23,"Washington Wizards",96,"Milwaukee Bucks",123,15921,1,27,27,"2016-17",54.5454545454545
"448",2016-12-23,"Sacramento Kings",109,"Minnesota Timberwolves",105,13288,0,-4,4,"2016-17",48.780487804878
"449",2016-12-23,"Miami Heat",87,"New Orleans Pelicans",91,16322,1,4,4,"2016-17",51.219512195122
"450",2016-12-23,"Atlanta Hawks",109,"Denver Nuggets",108,13823,0,-1,1,"2016-17",53.6585365853659
"451",2016-12-23,"Philadelphia 76ers",116,"Phoenix Suns",123,16535,1,7,7,"2016-17",36.5853658536585
"452",2016-12-23,"Toronto Raptors",104,"Utah Jazz",98,19911,0,-6,6,"2016-17",65.2173913043478
"453",2016-12-23,"San Antonio Spurs",110,"Portland Trail Blazers",90,19393,0,-20,20,"2016-17",58.1395348837209
"454",2016-12-23,"Dallas Mavericks",90,"Los Angeles Clippers",88,19060,0,-2,2,"2016-17",66.6666666666667
"455",2016-12-25,"Boston Celtics",119,"New York Knicks",114,19812,0,-5,5,"2016-17",46.3414634146341
"456",2016-12-25,"Golden State Warriors",108,"Cleveland Cavaliers",109,20562,1,1,1,"2016-17",75.5102040816327
"457",2016-12-25,"Chicago Bulls",100,"San Antonio Spurs",119,18428,1,19,19,"2016-17",73.469387755102
"458",2016-12-25,"Minnesota Timberwolves",100,"Oklahoma City Thunder",112,18203,1,12,12,"2016-17",67.4418604651163
"459",2016-12-25,"Los Angeles Clippers",102,"Los Angeles Lakers",111,18997,1,9,9,"2016-17",41.4634146341463
"460",2016-12-26,"Memphis Grizzlies",102,"Orlando Magic",112,17104,1,10,10,"2016-17",39.0243902439024
"461",2016-12-26,"Milwaukee Bucks",102,"Washington Wizards",107,15773,1,5,5,"2016-17",76.5957446808511
"462",2016-12-26,"Charlotte Hornets",118,"Brooklyn Nets",120,17732,1,2,2,"2016-17",31.7073170731707
"463",2016-12-26,"Cleveland Cavaliers",90,"Detroit Pistons",106,18123,1,16,16,"2016-17",58.5365853658537
"464",2016-12-26,"Indiana Pacers",85,"Chicago Bulls",90,21922,1,5,5,"2016-17",56.8181818181818
"465",2016-12-26,"Phoenix Suns",115,"Houston Rockets",131,18055,1,16,16,"2016-17",72.3404255319149
"466",2016-12-26,"Atlanta Hawks",90,"Minnesota Timberwolves",104,15617,1,14,14,"2016-17",48.780487804878
"467",2016-12-26,"Dallas Mavericks",104,"New Orleans Pelicans",111,15764,1,7,7,"2016-17",51.219512195122
"468",2016-12-26,"Toronto Raptors",95,"Portland Trail Blazers",91,19393,0,-4,4,"2016-17",58.1395348837209
"469",2016-12-26,"Denver Nuggets",106,"Los Angeles Clippers",102,19060,0,-4,4,"2016-17",66.6666666666667
"470",2016-12-26,"Philadelphia 76ers",100,"Sacramento Kings",102,17608,1,2,2,"2016-17",41.4634146341463
"471",2016-12-27,"Memphis Grizzlies",103,"Boston Celtics",113,18624,1,10,10,"2016-17",68.6274509803922
"472",2016-12-27,"Oklahoma City Thunder",106,"Miami Heat",94,19977,0,-12,12,"2016-17",56.0975609756098
"473",2016-12-27,"Houston Rockets",123,"Dallas Mavericks",107,20425,0,-16,16,"2016-17",51.219512195122
"474",2016-12-27,"Utah Jazz",102,"Los Angeles Lakers",100,18997,0,-2,2,"2016-17",41.4634146341463
"475",2016-12-28,"Charlotte Hornets",120,"Orlando Magic",101,18273,0,-19,19,"2016-17",39.0243902439024
"476",2016-12-28,"Indiana Pacers",105,"Washington Wizards",111,16172,1,6,6,"2016-17",76.5957446808511
"477",2016-12-28,"New York Knicks",98,"Atlanta Hawks",102,19066,1,4,4,"2016-17",56.8181818181818
"478",2016-12-28,"Milwaukee Bucks",119,"Detroit Pistons",94,17222,0,-25,25,"2016-17",58.5365853658537
"479",2016-12-28,"Brooklyn Nets",99,"Chicago Bulls",101,21957,1,2,2,"2016-17",56.8181818181818
"480",2016-12-28,"Los Angeles Clippers",98,"New Orleans Pelicans",102,16647,1,4,4,"2016-17",51.219512195122
"481",2016-12-28,"Phoenix Suns",98,"San Antonio Spurs",119,18418,1,21,21,"2016-17",73.469387755102
"482",2016-12-28,"Minnesota Timberwolves",103,"Denver Nuggets",105,15093,1,2,2,"2016-17",53.6585365853659
"483",2016-12-28,"Sacramento Kings",89,"Portland Trail Blazers",102,19665,1,13,13,"2016-17",58.1395348837209
"484",2016-12-28,"Toronto Raptors",111,"Golden State Warriors",121,19596,1,10,10,"2016-17",90
"485",2016-12-29,"Miami Heat",82,"Charlotte Hornets",91,19471,1,9,9,"2016-17",53.6585365853659
"486",2016-12-29,"Boston Celtics",118,"Cleveland Cavaliers",124,20562,1,6,6,"2016-17",75.5102040816327
"487",2016-12-29,"Oklahoma City Thunder",80,"Memphis Grizzlies",114,18119,1,34,34,"2016-17",59.0909090909091
"488",2016-12-29,"Toronto Raptors",91,"Phoenix Suns",99,18055,1,8,8,"2016-17",36.5853658536585
"489",2016-12-29,"Philadelphia 76ers",83,"Utah Jazz",100,19911,1,17,17,"2016-17",65.2173913043478
"490",2016-12-29,"Dallas Mavericks",101,"Los Angeles Lakers",89,18997,0,-12,12,"2016-17",41.4634146341463
"491",2016-12-30,"Chicago Bulls",101,"Indiana Pacers",111,17923,1,10,10,"2016-17",67.4418604651163
"492",2016-12-30,"Brooklyn Nets",95,"Washington Wizards",118,16461,1,23,23,"2016-17",76.5957446808511
"493",2016-12-30,"Miami Heat",114,"Boston Celtics",117,18624,1,3,3,"2016-17",68.6274509803922
"494",2016-12-30,"Detroit Pistons",98,"Atlanta Hawks",105,19009,1,7,7,"2016-17",56.8181818181818
"495",2016-12-30,"Los Angeles Clippers",116,"Houston Rockets",140,18055,1,24,24,"2016-17",72.3404255319149
"496",2016-12-30,"Milwaukee Bucks",99,"Minnesota Timberwolves",116,17779,1,17,17,"2016-17",48.780487804878
"497",2016-12-30,"New York Knicks",92,"New Orleans Pelicans",104,18124,1,12,12,"2016-17",51.219512195122
"498",2016-12-30,"Portland Trail Blazers",94,"San Antonio Spurs",110,18418,1,16,16,"2016-17",73.469387755102
"499",2016-12-30,"Philadelphia 76ers",124,"Denver Nuggets",122,13619,0,-2,2,"2016-17",53.6585365853659
"500",2016-12-30,"Dallas Mavericks",99,"Golden State Warriors",108,19596,1,9,9,"2016-17",90
"501",2016-12-31,"Memphis Grizzlies",112,"Sacramento Kings",98,17608,0,-14,14,"2016-17",41.4634146341463
"502",2016-12-31,"Milwaukee Bucks",116,"Chicago Bulls",96,21838,0,-20,20,"2016-17",56.8181818181818
"503",2016-12-31,"Cleveland Cavaliers",121,"Charlotte Hornets",109,19519,0,-12,12,"2016-17",53.6585365853659
"504",2016-12-31,"New York Knicks",122,"Houston Rockets",129,18055,1,7,7,"2016-17",72.3404255319149
"505",2016-12-31,"Los Angeles Clippers",88,"Oklahoma City Thunder",114,18203,1,26,26,"2016-17",67.4418604651163
"506",2016-12-31,"Phoenix Suns",86,"Utah Jazz",91,19911,1,5,5,"2016-17",65.2173913043478
"507",2017-01-01,"San Antonio Spurs",112,"Atlanta Hawks",114,18088,1,2,2,"2016-17",56.8181818181818
"508",2017-01-01,"Orlando Magic",104,"Indiana Pacers",117,17530,1,13,13,"2016-17",67.4418604651163
"509",2017-01-01,"Detroit Pistons",107,"Miami Heat",98,19844,0,-9,9,"2016-17",56.0975609756098
"510",2017-01-01,"Portland Trail Blazers",95,"Minnesota Timberwolves",89,15804,0,-6,6,"2016-17",48.780487804878
"511",2017-01-01,"Toronto Raptors",123,"Los Angeles Lakers",114,18997,0,-9,9,"2016-17",41.4634146341463
"512",2017-01-02,"New Orleans Pelicans",82,"Cleveland Cavaliers",90,20562,1,8,8,"2016-17",75.5102040816327
"513",2017-01-02,"Oklahoma City Thunder",94,"Milwaukee Bucks",98,17423,1,4,4,"2016-17",54.5454545454545
"514",2017-01-02,"Utah Jazz",101,"Brooklyn Nets",89,15634,0,-12,12,"2016-17",31.7073170731707
"515",2017-01-02,"Orlando Magic",115,"New York Knicks",103,19812,0,-12,12,"2016-17",46.3414634146341
"516",2017-01-02,"Charlotte Hornets",111,"Chicago Bulls",118,21612,1,7,7,"2016-17",56.8181818181818
"517",2017-01-02,"Washington Wizards",91,"Houston Rockets",101,16569,1,10,10,"2016-17",72.3404255319149
"518",2017-01-02,"Denver Nuggets",119,"Golden State Warriors",127,19596,1,8,8,"2016-17",90
"519",2017-01-02,"Phoenix Suns",98,"Los Angeles Clippers",109,19060,1,11,11,"2016-17",66.6666666666667
"520",2017-01-03,"Minnesota Timberwolves",91,"Philadelphia 76ers",93,17124,1,2,2,"2016-17",41.4634146341463
"521",2017-01-03,"Utah Jazz",104,"Boston Celtics",115,18624,1,11,11,"2016-17",68.6274509803922
"522",2017-01-03,"Indiana Pacers",121,"Detroit Pistons",116,13435,0,-5,5,"2016-17",58.5365853658537
"523",2017-01-03,"Washington Wizards",105,"Dallas Mavericks",113,19318,1,8,8,"2016-17",51.219512195122
"524",2017-01-03,"Toronto Raptors",82,"San Antonio Spurs",110,18418,1,28,28,"2016-17",73.469387755102
"525",2017-01-03,"Sacramento Kings",120,"Denver Nuggets",113,11018,0,-7,7,"2016-17",53.6585365853659
"526",2017-01-03,"Miami Heat",90,"Phoenix Suns",99,16772,1,9,9,"2016-17",36.5853658536585
"527",2017-01-03,"Memphis Grizzlies",102,"Los Angeles Lakers",116,18997,1,14,14,"2016-17",41.4634146341463
"528",2017-01-04,"Oklahoma City Thunder",112,"Charlotte Hornets",123,18418,1,11,11,"2016-17",53.6585365853659
"529",2017-01-04,"Atlanta Hawks",111,"Orlando Magic",92,18846,0,-19,19,"2016-17",39.0243902439024
"530",2017-01-04,"Milwaukee Bucks",105,"New York Knicks",104,19812,0,-1,1,"2016-17",46.3414634146341
"531",2017-01-04,"Chicago Bulls",106,"Cleveland Cavaliers",94,20562,0,-12,12,"2016-17",75.5102040816327
"532",2017-01-04,"Portland Trail Blazers",117,"Golden State Warriors",125,19596,1,8,8,"2016-17",90
"533",2017-01-04,"Memphis Grizzlies",106,"Los Angeles Clippers",115,19060,1,9,9,"2016-17",66.6666666666667
"534",2017-01-04,"Miami Heat",107,"Sacramento Kings",102,17608,0,-5,5,"2016-17",41.4634146341463
"535",2017-01-05,"Brooklyn Nets",109,"Indiana Pacers",121,16421,1,12,12,"2016-17",67.4418604651163
"536",2017-01-05,"Charlotte Hornets",114,"Detroit Pistons",115,13723,1,1,1,"2016-17",58.5365853658537
"537",2017-01-05,"Utah Jazz",93,"Toronto Raptors",101,19800,1,8,8,"2016-17",65.2173913043478
"538",2017-01-05,"Oklahoma City Thunder",116,"Houston Rockets",118,18055,1,2,2,"2016-17",72.3404255319149
"539",2017-01-05,"Atlanta Hawks",99,"New Orleans Pelicans",94,15003,0,-5,5,"2016-17",51.219512195122
"540",2017-01-05,"Phoenix Suns",102,"Dallas Mavericks",95,19570,0,-7,7,"2016-17",51.219512195122
"541",2017-01-05,"San Antonio Spurs",127,"Denver Nuggets",99,14391,0,-28,28,"2016-17",53.6585365853659
"542",2017-01-05,"Los Angeles Lakers",109,"Portland Trail Blazers",118,19403,1,9,9,"2016-17",58.1395348837209
"543",2017-01-06,"Houston Rockets",100,"Orlando Magic",93,19272,0,-7,7,"2016-17",39.0243902439024
"544",2017-01-06,"Minnesota Timberwolves",105,"Washington Wizards",112,18686,1,7,7,"2016-17",76.5957446808511
"545",2017-01-06,"Philadelphia 76ers",106,"Boston Celtics",110,18624,1,4,4,"2016-17",68.6274509803922
"546",2017-01-06,"Cleveland Cavaliers",116,"Brooklyn Nets",108,17732,0,-8,8,"2016-17",31.7073170731707
"547",2017-01-06,"New York Knicks",116,"Milwaukee Bucks",111,18717,0,-5,5,"2016-17",54.5454545454545
"548",2017-01-06,"Memphis Grizzlies",128,"Golden State Warriors",119,19596,0,-9,9,"2016-17",90
"549",2017-01-06,"Miami Heat",100,"Los Angeles Lakers",127,18997,1,27,27,"2016-17",41.4634146341463
"550",2017-01-06,"Los Angeles Clippers",106,"Sacramento Kings",98,17608,0,-8,8,"2016-17",41.4634146341463
"551",2017-01-07,"New York Knicks",109,"Indiana Pacers",123,17367,1,14,14,"2016-17",67.4418604651163
"552",2017-01-07,"New Orleans Pelicans",108,"Boston Celtics",117,18624,1,9,9,"2016-17",68.6274509803922
"553",2017-01-07,"Toronto Raptors",118,"Chicago Bulls",123,21195,1,5,5,"2016-17",56.8181818181818
"554",2017-01-07,"Utah Jazz",94,"Minnesota Timberwolves",92,13945,0,-2,2,"2016-17",48.780487804878
"555",2017-01-07,"Denver Nuggets",106,"Oklahoma City Thunder",121,18203,1,15,15,"2016-17",67.4418604651163
"556",2017-01-07,"Atlanta Hawks",97,"Dallas Mavericks",82,19655,0,-15,15,"2016-17",51.219512195122
"557",2017-01-07,"Charlotte Hornets",85,"San Antonio Spurs",102,18418,1,17,17,"2016-17",73.469387755102
"558",2017-01-08,"Philadelphia 76ers",105,"Brooklyn Nets",95,16123,0,-10,10,"2016-17",31.7073170731707
"559",2017-01-08,"Washington Wizards",107,"Milwaukee Bucks",101,15311,0,-6,6,"2016-17",54.5454545454545
"560",2017-01-08,"Miami Heat",86,"Los Angeles Clippers",98,19060,1,12,12,"2016-17",66.6666666666667
"561",2017-01-08,"Houston Rockets",129,"Toronto Raptors",122,19800,0,-7,7,"2016-17",65.2173913043478
"562",2017-01-08,"Utah Jazz",79,"Memphis Grizzlies",88,16112,1,9,9,"2016-17",59.0909090909091
"563",2017-01-08,"Cleveland Cavaliers",120,"Phoenix Suns",116,18055,0,-4,4,"2016-17",36.5853658536585
"564",2017-01-08,"Detroit Pistons",125,"Portland Trail Blazers",124,13506,0,-1,1,"2016-17",58.1395348837209
"565",2017-01-08,"Golden State Warriors",117,"Sacramento Kings",106,17608,0,-11,11,"2016-17",41.4634146341463
"566",2017-01-08,"Orlando Magic",95,"Los Angeles Lakers",111,18997,1,16,16,"2016-17",41.4634146341463
"567",2017-01-09,"New Orleans Pelicans",110,"New York Knicks",96,19812,0,-14,14,"2016-17",46.3414634146341
"568",2017-01-09,"Oklahoma City Thunder",109,"Chicago Bulls",94,21923,0,-15,15,"2016-17",56.8181818181818
"569",2017-01-09,"Dallas Mavericks",92,"Minnesota Timberwolves",101,9625,1,9,9,"2016-17",48.780487804878
"570",2017-01-10,"Chicago Bulls",99,"Washington Wizards",101,14361,1,2,2,"2016-17",76.5957446808511
"571",2017-01-10,"Atlanta Hawks",117,"Brooklyn Nets",97,13279,0,-20,20,"2016-17",31.7073170731707
"572",2017-01-10,"Boston Celtics",106,"Toronto Raptors",114,19800,1,8,8,"2016-17",65.2173913043478
"573",2017-01-10,"Charlotte Hornets",114,"Houston Rockets",121,16196,1,7,7,"2016-17",72.3404255319149
"574",2017-01-10,"Milwaukee Bucks",109,"San Antonio Spurs",107,18418,0,-2,2,"2016-17",73.469387755102
"575",2017-01-10,"Cleveland Cavaliers",92,"Utah Jazz",100,19911,1,8,8,"2016-17",65.2173913043478
"576",2017-01-10,"Miami Heat",95,"Golden State Warriors",107,19596,1,12,12,"2016-17",90
"577",2017-01-10,"Portland Trail Blazers",108,"Los Angeles Lakers",87,18483,0,-21,21,"2016-17",41.4634146341463
"578",2017-01-10,"Detroit Pistons",94,"Sacramento Kings",100,17608,1,6,6,"2016-17",41.4634146341463
"579",2017-01-11,"New York Knicks",97,"Philadelphia 76ers",98,18755,1,1,1,"2016-17",41.4634146341463
"580",2017-01-11,"Washington Wizards",108,"Boston Celtics",117,18624,1,9,9,"2016-17",68.6274509803922
"581",2017-01-11,"Houston Rockets",105,"Minnesota Timberwolves",119,13858,1,14,14,"2016-17",48.780487804878
"582",2017-01-11,"Memphis Grizzlies",95,"Oklahoma City Thunder",103,18203,1,8,8,"2016-17",67.4418604651163
"583",2017-01-11,"Orlando Magic",96,"Los Angeles Clippers",105,19060,1,9,9,"2016-17",66.6666666666667
"584",2017-01-11,"Cleveland Cavaliers",86,"Portland Trail Blazers",102,19393,1,16,16,"2016-17",58.1395348837209
"585",2017-01-12,"Indiana Pacers",112,"Denver Nuggets",140,18689,1,28,28,"2016-17",53.6585365853659
"586",2017-01-12,"New Orleans Pelicans",104,"Brooklyn Nets",95,14352,0,-9,9,"2016-17",31.7073170731707
"587",2017-01-12,"Chicago Bulls",89,"New York Knicks",104,19812,1,15,15,"2016-17",46.3414634146341
"588",2017-01-12,"Los Angeles Lakers",94,"San Antonio Spurs",134,18418,1,40,40,"2016-17",73.469387755102
"589",2017-01-12,"Dallas Mavericks",113,"Phoenix Suns",108,19874,0,-5,5,"2016-17",36.5853658536585
"590",2017-01-12,"Detroit Pistons",107,"Golden State Warriors",127,19596,1,20,20,"2016-17",90
"591",2017-01-13,"Charlotte Hornets",93,"Philadelphia 76ers",102,18215,1,9,9,"2016-17",41.4634146341463
"592",2017-01-13,"Brooklyn Nets",113,"Toronto Raptors",132,19800,1,19,19,"2016-17",65.2173913043478
"593",2017-01-13,"Boston Celtics",103,"Atlanta Hawks",101,18216,0,-2,2,"2016-17",56.8181818181818
"594",2017-01-13,"Memphis Grizzlies",110,"Houston Rockets",105,18055,0,-5,5,"2016-17",72.3404255319149
"595",2017-01-13,"Miami Heat",108,"Milwaukee Bucks",116,17483,1,8,8,"2016-17",54.5454545454545
"596",2017-01-13,"Oklahoma City Thunder",86,"Minnesota Timberwolves",96,16644,1,10,10,"2016-17",48.780487804878
"597",2017-01-13,"Orlando Magic",115,"Portland Trail Blazers",109,19344,0,-6,6,"2016-17",58.1395348837209
"598",2017-01-13,"Cleveland Cavaliers",120,"Sacramento Kings",108,17608,0,-12,12,"2016-17",41.4634146341463
"599",2017-01-13,"Detroit Pistons",77,"Utah Jazz",110,19911,1,33,33,"2016-17",65.2173913043478
"600",2017-01-14,"Los Angeles Lakers",97,"Los Angeles Clippers",113,19060,1,16,16,"2016-17",66.6666666666667
"601",2017-01-14,"New Orleans Pelicans",99,"Chicago Bulls",107,21916,1,8,8,"2016-17",56.8181818181818
"602",2017-01-14,"San Antonio Spurs",105,"Phoenix Suns",108,20532,1,3,3,"2016-17",36.5853658536585
"603",2017-01-14,"Philadelphia 76ers",93,"Washington Wizards",109,17880,1,16,16,"2016-17",76.5957446808511
"604",2017-01-14,"Orlando Magic",107,"Utah Jazz",114,19911,1,7,7,"2016-17",65.2173913043478
"605",2017-01-15,"Minnesota Timberwolves",87,"Dallas Mavericks",98,19655,1,11,11,"2016-17",51.219512195122
"606",2017-01-15,"Milwaukee Bucks",98,"Atlanta Hawks",111,14231,1,13,13,"2016-17",56.8181818181818
"607",2017-01-15,"New York Knicks",101,"Toronto Raptors",116,19800,1,15,15,"2016-17",65.2173913043478
"608",2017-01-15,"Houston Rockets",137,"Brooklyn Nets",112,17732,0,-25,25,"2016-17",31.7073170731707
"609",2017-01-15,"Chicago Bulls",108,"Memphis Grizzlies",104,18119,0,-4,4,"2016-17",59.0909090909091
"610",2017-01-15,"Oklahoma City Thunder",122,"Sacramento Kings",118,17608,0,-4,4,"2016-17",41.4634146341463
"611",2017-01-15,"Detroit Pistons",102,"Los Angeles Lakers",97,18997,0,-5,5,"2016-17",41.4634146341463
"612",2017-01-16,"Atlanta Hawks",108,"New York Knicks",107,19812,0,-1,1,"2016-17",46.3414634146341
"613",2017-01-16,"Portland Trail Blazers",101,"Washington Wizards",120,17395,1,19,19,"2016-17",76.5957446808511
"614",2017-01-16,"Philadelphia 76ers",113,"Milwaukee Bucks",104,13261,0,-9,9,"2016-17",54.5454545454545
"615",2017-01-16,"New Orleans Pelicans",95,"Indiana Pacers",98,15525,1,3,3,"2016-17",67.4418604651163
"616",2017-01-16,"Orlando Magic",112,"Denver Nuggets",125,11217,1,13,13,"2016-17",53.6585365853659
"617",2017-01-16,"Charlotte Hornets",98,"Boston Celtics",108,18624,1,10,10,"2016-17",68.6274509803922
"618",2017-01-16,"Cleveland Cavaliers",91,"Golden State Warriors",126,19596,1,35,35,"2016-17",90
"619",2017-01-16,"Utah Jazz",106,"Phoenix Suns",101,16767,0,-5,5,"2016-17",36.5853658536585
"620",2017-01-16,"Oklahoma City Thunder",98,"Los Angeles Clippers",120,19060,1,22,22,"2016-17",66.6666666666667
"621",2017-01-17,"Toronto Raptors",119,"Brooklyn Nets",109,12874,0,-10,10,"2016-17",31.7073170731707
"622",2017-01-17,"Houston Rockets",103,"Miami Heat",109,19600,1,6,6,"2016-17",56.0975609756098
"623",2017-01-17,"Dallas Mavericks",99,"Chicago Bulls",98,21294,0,-1,1,"2016-17",56.8181818181818
"624",2017-01-17,"Minnesota Timberwolves",114,"San Antonio Spurs",122,18418,1,8,8,"2016-17",73.469387755102
"625",2017-01-17,"Denver Nuggets",127,"Los Angeles Lakers",121,18412,0,-6,6,"2016-17",41.4634146341463
"626",2017-01-18,"Portland Trail Blazers",85,"Charlotte Hornets",107,15451,1,22,22,"2016-17",53.6585365853659
"627",2017-01-18,"Toronto Raptors",89,"Philadelphia 76ers",94,17223,1,5,5,"2016-17",41.4634146341463
"628",2017-01-18,"Memphis Grizzlies",101,"Washington Wizards",104,15079,1,3,3,"2016-17",76.5957446808511
"629",2017-01-18,"New York Knicks",117,"Boston Celtics",106,18624,0,-11,11,"2016-17",68.6274509803922
"630",2017-01-18,"Atlanta Hawks",95,"Detroit Pistons",118,15159,1,23,23,"2016-17",58.5365853658537
"631",2017-01-18,"Milwaukee Bucks",92,"Houston Rockets",111,15782,1,19,19,"2016-17",72.3404255319149
"632",2017-01-18,"Orlando Magic",98,"New Orleans Pelicans",118,15818,1,20,20,"2016-17",51.219512195122
"633",2017-01-18,"Oklahoma City Thunder",100,"Golden State Warriors",121,19596,1,21,21,"2016-17",90
"634",2017-01-18,"Indiana Pacers",106,"Sacramento Kings",100,17608,0,-6,6,"2016-17",41.4634146341463
"635",2017-01-19,"Phoenix Suns",103,"Cleveland Cavaliers",118,20562,1,15,15,"2016-17",75.5102040816327
"636",2017-01-19,"Dallas Mavericks",95,"Miami Heat",99,19600,1,4,4,"2016-17",56.0975609756098
"637",2017-01-19,"Washington Wizards",113,"New York Knicks",110,19812,0,-3,3,"2016-17",46.3414634146341
"638",2017-01-19,"Denver Nuggets",104,"San Antonio Spurs",118,18418,1,14,14,"2016-17",73.469387755102
"639",2017-01-19,"Minnesota Timberwolves",104,"Los Angeles Clippers",101,19060,0,-3,3,"2016-17",66.6666666666667
"640",2017-01-20,"Toronto Raptors",78,"Charlotte Hornets",113,18378,1,35,35,"2016-17",53.6585365853659
"641",2017-01-20,"Milwaukee Bucks",96,"Orlando Magic",112,19307,1,16,16,"2016-17",39.0243902439024
"642",2017-01-20,"Portland Trail Blazers",92,"Philadelphia 76ers",93,19476,1,1,1,"2016-17",41.4634146341463
"643",2017-01-20,"Chicago Bulls",93,"Atlanta Hawks",102,16328,1,9,9,"2016-17",56.8181818181818
"644",2017-01-20,"Golden State Warriors",125,"Houston Rockets",108,18055,0,-17,17,"2016-17",72.3404255319149
"645",2017-01-20,"Sacramento Kings",91,"Memphis Grizzlies",107,16991,1,16,16,"2016-17",59.0909090909091
"646",2017-01-20,"Brooklyn Nets",143,"New Orleans Pelicans",114,17004,0,-29,29,"2016-17",51.219512195122
"647",2017-01-20,"Utah Jazz",112,"Dallas Mavericks",107,19421,0,-5,5,"2016-17",51.219512195122
"648",2017-01-20,"Indiana Pacers",95,"Los Angeles Lakers",108,18997,1,13,13,"2016-17",41.4634146341463
"649",2017-01-21,"Portland Trail Blazers",127,"Boston Celtics",123,18624,0,-4,4,"2016-17",68.6274509803922
"650",2017-01-21,"Washington Wizards",112,"Detroit Pistons",113,18231,1,1,1,"2016-17",58.5365853658537
"651",2017-01-21,"Philadelphia 76ers",93,"Atlanta Hawks",110,15116,1,17,17,"2016-17",56.8181818181818
"652",2017-01-21,"Brooklyn Nets",105,"Charlotte Hornets",112,18583,1,7,7,"2016-17",53.6585365853659
"653",2017-01-21,"Milwaukee Bucks",97,"Miami Heat",109,19600,1,12,12,"2016-17",56.0975609756098
"654",2017-01-21,"Phoenix Suns",107,"New York Knicks",105,19812,0,-2,2,"2016-17",46.3414634146341
"655",2017-01-21,"Houston Rockets",119,"Memphis Grizzlies",95,18119,0,-24,24,"2016-17",59.0909090909091
"656",2017-01-21,"San Antonio Spurs",118,"Cleveland Cavaliers",115,20562,0,-3,3,"2016-17",75.5102040816327
"657",2017-01-21,"Sacramento Kings",99,"Chicago Bulls",102,21606,1,3,3,"2016-17",56.8181818181818
"658",2017-01-21,"Los Angeles Clippers",98,"Denver Nuggets",123,16056,1,25,25,"2016-17",53.6585365853659
"659",2017-01-21,"Indiana Pacers",100,"Utah Jazz",109,19911,1,9,9,"2016-17",65.2173913043478
"660",2017-01-22,"Golden State Warriors",118,"Orlando Magic",98,18846,0,-20,20,"2016-17",39.0243902439024
"661",2017-01-22,"Los Angeles Lakers",73,"Dallas Mavericks",122,19484,1,49,49,"2016-17",51.219512195122
"662",2017-01-22,"Phoenix Suns",115,"Toronto Raptors",103,19800,0,-12,12,"2016-17",65.2173913043478
"663",2017-01-22,"Denver Nuggets",108,"Minnesota Timberwolves",111,12788,1,3,3,"2016-17",48.780487804878
"664",2017-01-23,"Washington Wizards",109,"Charlotte Hornets",99,15285,0,-10,10,"2016-17",53.6585365853659
"665",2017-01-23,"Los Angeles Clippers",115,"Atlanta Hawks",105,12853,0,-10,10,"2016-17",56.8181818181818
"666",2017-01-23,"San Antonio Spurs",112,"Brooklyn Nets",86,16643,0,-26,26,"2016-17",31.7073170731707
"667",2017-01-23,"Sacramento Kings",109,"Detroit Pistons",104,14017,0,-5,5,"2016-17",58.5365853658537
"668",2017-01-23,"Golden State Warriors",102,"Miami Heat",105,19600,1,3,3,"2016-17",56.0975609756098
"669",2017-01-23,"New York Knicks",109,"Indiana Pacers",103,16015,0,-6,6,"2016-17",67.4418604651163
"670",2017-01-23,"Houston Rockets",114,"Milwaukee Bucks",127,14016,1,13,13,"2016-17",54.5454545454545
"671",2017-01-23,"Cleveland Cavaliers",122,"New Orleans Pelicans",124,17758,1,2,2,"2016-17",51.219512195122
"672",2017-01-23,"Oklahoma City Thunder",97,"Utah Jazz",95,19911,0,-2,2,"2016-17",65.2173913043478
"673",2017-01-24,"Chicago Bulls",100,"Orlando Magic",92,18846,0,-8,8,"2016-17",39.0243902439024
"674",2017-01-24,"Los Angeles Clippers",110,"Philadelphia 76ers",121,17591,1,11,11,"2016-17",41.4634146341463
"675",2017-01-24,"San Antonio Spurs",108,"Toronto Raptors",106,19800,0,-2,2,"2016-17",65.2173913043478
"676",2017-01-24,"Boston Celtics",108,"Washington Wizards",123,16387,1,15,15,"2016-17",76.5957446808511
"677",2017-01-24,"Utah Jazz",93,"Denver Nuggets",103,10867,1,10,10,"2016-17",53.6585365853659
"678",2017-01-24,"Minnesota Timberwolves",112,"Phoenix Suns",111,17241,0,-1,1,"2016-17",36.5853658536585
"679",2017-01-25,"Sacramento Kings",116,"Cleveland Cavaliers",112,20562,0,-4,4,"2016-17",75.5102040816327
"680",2017-01-25,"Houston Rockets",109,"Boston Celtics",120,18624,1,11,11,"2016-17",68.6274509803922
"681",2017-01-25,"Miami Heat",109,"Brooklyn Nets",106,14929,0,-3,3,"2016-17",31.7073170731707
"682",2017-01-25,"Atlanta Hawks",119,"Chicago Bulls",114,21445,0,-5,5,"2016-17",56.8181818181818
"683",2017-01-25,"Golden State Warriors",113,"Charlotte Hornets",103,19639,0,-10,10,"2016-17",53.6585365853659
"684",2017-01-25,"Toronto Raptors",99,"Memphis Grizzlies",101,15904,1,2,2,"2016-17",59.0909090909091
"685",2017-01-25,"Philadelphia 76ers",114,"Milwaukee Bucks",109,13663,0,-5,5,"2016-17",54.5454545454545
"686",2017-01-25,"Oklahoma City Thunder",114,"New Orleans Pelicans",105,15277,0,-9,9,"2016-17",51.219512195122
"687",2017-01-25,"New York Knicks",95,"Dallas Mavericks",103,19750,1,8,8,"2016-17",51.219512195122
"688",2017-01-25,"Los Angeles Lakers",98,"Portland Trail Blazers",105,19393,1,7,7,"2016-17",58.1395348837209
"689",2017-01-26,"Indiana Pacers",109,"Minnesota Timberwolves",103,14862,0,-6,6,"2016-17",48.780487804878
"690",2017-01-26,"Dallas Mavericks",98,"Oklahoma City Thunder",109,18203,1,11,11,"2016-17",67.4418604651163
"691",2017-01-26,"Phoenix Suns",120,"Denver Nuggets",127,12231,1,7,7,"2016-17",53.6585365853659
"692",2017-01-26,"Los Angeles Lakers",88,"Utah Jazz",96,19911,1,8,8,"2016-17",65.2173913043478
"693",2017-01-27,"Sacramento Kings",111,"Indiana Pacers",115,17522,1,4,4,"2016-17",67.4418604651163
"694",2017-01-27,"Orlando Magic",98,"Boston Celtics",128,18624,1,30,30,"2016-17",68.6274509803922
"695",2017-01-27,"Brooklyn Nets",116,"Cleveland Cavaliers",124,20562,1,8,8,"2016-17",75.5102040816327
"696",2017-01-27,"Charlotte Hornets",107,"New York Knicks",110,19812,1,3,3,"2016-17",46.3414634146341
"697",2017-01-27,"Milwaukee Bucks",86,"Toronto Raptors",102,19800,1,16,16,"2016-17",65.2173913043478
"698",2017-01-27,"Washington Wizards",112,"Atlanta Hawks",86,16968,0,-26,26,"2016-17",56.8181818181818
"699",2017-01-27,"Miami Heat",100,"Chicago Bulls",88,22082,0,-12,12,"2016-17",56.8181818181818
"700",2017-01-27,"San Antonio Spurs",103,"New Orleans Pelicans",119,17757,1,16,16,"2016-17",51.219512195122
"701",2017-01-27,"Houston Rockets",123,"Philadelphia 76ers",118,20588,0,-5,5,"2016-17",41.4634146341463
"702",2017-01-27,"Memphis Grizzlies",109,"Portland Trail Blazers",112,19558,1,3,3,"2016-17",58.1395348837209
"703",2017-01-28,"Sacramento Kings",109,"Charlotte Hornets",106,18597,0,-3,3,"2016-17",53.6585365853659
"704",2017-01-28,"Detroit Pistons",103,"Miami Heat",116,19600,1,13,13,"2016-17",56.0975609756098
"705",2017-01-28,"Boston Celtics",112,"Milwaukee Bucks",108,18717,0,-4,4,"2016-17",54.5454545454545
"706",2017-01-28,"Los Angeles Clippers",98,"Golden State Warriors",144,19596,1,46,46,"2016-17",90
"707",2017-01-28,"Brooklyn Nets",109,"Minnesota Timberwolves",129,14798,1,20,20,"2016-17",48.780487804878
"708",2017-01-28,"Denver Nuggets",123,"Phoenix Suns",112,18055,0,-11,11,"2016-17",36.5853658536585
"709",2017-01-28,"Memphis Grizzlies",102,"Utah Jazz",95,19911,0,-7,7,"2016-17",65.2173913043478
"710",2017-01-29,"New York Knicks",139,"Atlanta Hawks",142,13643,1,3,3,"2016-17",56.8181818181818
"711",2017-01-29,"Oklahoma City Thunder",91,"Cleveland Cavaliers",107,20562,1,16,16,"2016-17",75.5102040816327
"712",2017-01-29,"Houston Rockets",101,"Indiana Pacers",120,17923,1,19,19,"2016-17",67.4418604651163
"713",2017-01-29,"Washington Wizards",107,"New Orleans Pelicans",94,16779,0,-13,13,"2016-17",51.219512195122
"714",2017-01-29,"Orlando Magic",114,"Toronto Raptors",113,19800,0,-1,1,"2016-17",65.2173913043478
"715",2017-01-29,"Philadelphia 76ers",108,"Chicago Bulls",121,21606,1,13,13,"2016-17",56.8181818181818
"716",2017-01-29,"Dallas Mavericks",105,"San Antonio Spurs",101,18418,0,-4,4,"2016-17",73.469387755102
"717",2017-01-29,"Golden State Warriors",113,"Portland Trail Blazers",111,19393,0,-2,2,"2016-17",58.1395348837209
"718",2017-01-30,"Sacramento Kings",119,"Philadelphia 76ers",122,15840,1,3,3,"2016-17",41.4634146341463
"719",2017-01-30,"Brooklyn Nets",96,"Miami Heat",104,19600,1,8,8,"2016-17",56.0975609756098
"720",2017-01-30,"Detroit Pistons",109,"Boston Celtics",113,18188,1,4,4,"2016-17",68.6274509803922
"721",2017-01-30,"Orlando Magic",105,"Minnesota Timberwolves",111,11124,1,6,6,"2016-17",48.780487804878
"722",2017-01-30,"Cleveland Cavaliers",97,"Dallas Mavericks",104,20202,1,7,7,"2016-17",51.219512195122
"723",2017-01-30,"Memphis Grizzlies",115,"Phoenix Suns",96,16332,0,-19,19,"2016-17",36.5853658536585
"724",2017-01-31,"New Orleans Pelicans",106,"Toronto Raptors",108,19800,1,2,2,"2016-17",65.2173913043478
"725",2017-01-31,"New York Knicks",101,"Washington Wizards",117,16683,1,16,16,"2016-17",76.5957446808511
"726",2017-01-31,"Sacramento Kings",83,"Houston Rockets",105,15187,1,22,22,"2016-17",72.3404255319149
"727",2017-01-31,"Oklahoma City Thunder",94,"San Antonio Spurs",108,18418,1,14,14,"2016-17",73.469387755102
"728",2017-01-31,"Charlotte Hornets",98,"Portland Trail Blazers",115,19393,1,17,17,"2016-17",58.1395348837209
"729",2017-01-31,"Denver Nuggets",116,"Los Angeles Lakers",120,18997,1,4,4,"2016-17",41.4634146341463
"730",2017-02-01,"Minnesota Timberwolves",97,"Cleveland Cavaliers",125,20562,1,28,28,"2016-17",75.5102040816327
"731",2017-02-01,"Indiana Pacers",98,"Orlando Magic",88,16662,0,-10,10,"2016-17",39.0243902439024
"732",2017-02-01,"Toronto Raptors",104,"Boston Celtics",109,18624,1,5,5,"2016-17",68.6274509803922
"733",2017-02-01,"New York Knicks",95,"Brooklyn Nets",90,17732,0,-5,5,"2016-17",31.7073170731707
"734",2017-02-01,"New Orleans Pelicans",98,"Detroit Pistons",118,14262,1,20,20,"2016-17",58.5365853658537
"735",2017-02-01,"Atlanta Hawks",93,"Miami Heat",116,19600,1,23,23,"2016-17",56.0975609756098
"736",2017-02-01,"Philadelphia 76ers",95,"Dallas Mavericks",113,19263,1,18,18,"2016-17",51.219512195122
"737",2017-02-01,"Memphis Grizzlies",119,"Denver Nuggets",99,12020,0,-20,20,"2016-17",53.6585365853659
"738",2017-02-01,"Los Angeles Clippers",124,"Phoenix Suns",114,16191,0,-10,10,"2016-17",36.5853658536585
"739",2017-02-01,"Milwaukee Bucks",88,"Utah Jazz",104,19694,1,16,16,"2016-17",65.2173913043478
"740",2017-02-01,"Chicago Bulls",128,"Oklahoma City Thunder",100,18203,0,-28,28,"2016-17",67.4418604651163
"741",2017-02-01,"Charlotte Hornets",111,"Golden State Warriors",126,19596,1,15,15,"2016-17",90
"742",2017-02-02,"Los Angeles Lakers",108,"Washington Wizards",116,16473,1,8,8,"2016-17",76.5957446808511
"743",2017-02-02,"Atlanta Hawks",113,"Houston Rockets",108,15602,0,-5,5,"2016-17",72.3404255319149
"744",2017-02-02,"Philadelphia 76ers",86,"San Antonio Spurs",102,18418,1,16,16,"2016-17",73.469387755102
"745",2017-02-02,"Golden State Warriors",133,"Los Angeles Clippers",120,19385,0,-13,13,"2016-17",66.6666666666667
"746",2017-02-03,"Toronto Raptors",94,"Orlando Magic",102,17141,1,8,8,"2016-17",39.0243902439024
"747",2017-02-03,"Indiana Pacers",106,"Brooklyn Nets",97,14557,0,-9,9,"2016-17",31.7073170731707
"748",2017-02-03,"Minnesota Timberwolves",108,"Detroit Pistons",116,16934,1,8,8,"2016-17",58.5365853658537
"749",2017-02-03,"Los Angeles Lakers",107,"Boston Celtics",113,18624,1,6,6,"2016-17",68.6274509803922
"750",2017-02-03,"Chicago Bulls",117,"Houston Rockets",121,18055,1,4,4,"2016-17",72.3404255319149
"751",2017-02-03,"Memphis Grizzlies",102,"Oklahoma City Thunder",114,18203,1,12,12,"2016-17",67.4418604651163
"752",2017-02-03,"Milwaukee Bucks",117,"Denver Nuggets",121,18792,1,4,4,"2016-17",53.6585365853659
"753",2017-02-03,"Dallas Mavericks",108,"Portland Trail Blazers",104,19393,0,-4,4,"2016-17",58.1395348837209
"754",2017-02-03,"Phoenix Suns",105,"Sacramento Kings",103,17608,0,-2,2,"2016-17",41.4634146341463
"755",2017-02-04,"Orlando Magic",86,"Atlanta Hawks",113,16691,1,27,27,"2016-17",56.8181818181818
"756",2017-02-04,"Detroit Pistons",84,"Indiana Pacers",105,17660,1,21,21,"2016-17",67.4418604651163
"757",2017-02-04,"New Orleans Pelicans",91,"Washington Wizards",105,19651,1,14,14,"2016-17",76.5957446808511
"758",2017-02-04,"Philadelphia 76ers",102,"Miami Heat",125,19754,1,23,23,"2016-17",56.0975609756098
"759",2017-02-04,"Cleveland Cavaliers",111,"New York Knicks",104,19812,0,-7,7,"2016-17",46.3414634146341
"760",2017-02-04,"Memphis Grizzlies",107,"Minnesota Timberwolves",99,15081,0,-8,8,"2016-17",48.780487804878
"761",2017-02-04,"Milwaukee Bucks",137,"Phoenix Suns",112,17192,0,-25,25,"2016-17",36.5853658536585
"762",2017-02-04,"Denver Nuggets",97,"San Antonio Spurs",121,18418,1,24,24,"2016-17",73.469387755102
"763",2017-02-04,"Charlotte Hornets",98,"Utah Jazz",105,19911,1,7,7,"2016-17",65.2173913043478
"764",2017-02-04,"Golden State Warriors",106,"Sacramento Kings",109,17608,1,3,3,"2016-17",41.4634146341463
"765",2017-02-05,"Toronto Raptors",103,"Brooklyn Nets",95,14245,0,-8,8,"2016-17",31.7073170731707
"766",2017-02-05,"Los Angeles Clippers",102,"Boston Celtics",107,18624,1,5,5,"2016-17",68.6274509803922
"767",2017-02-05,"Portland Trail Blazers",99,"Oklahoma City Thunder",105,18203,1,6,6,"2016-17",67.4418604651163
"768",2017-02-06,"Oklahoma City Thunder",90,"Indiana Pacers",93,16123,1,3,3,"2016-17",67.4418604651163
"769",2017-02-06,"Los Angeles Lakers",121,"New York Knicks",107,19812,0,-14,14,"2016-17",46.3414634146341
"770",2017-02-06,"Cleveland Cavaliers",140,"Washington Wizards",135,20356,0,-5,5,"2016-17",76.5957446808511
"771",2017-02-06,"Utah Jazz",120,"Atlanta Hawks",95,13126,0,-25,25,"2016-17",56.8181818181818
"772",2017-02-06,"Philadelphia 76ers",96,"Detroit Pistons",113,14731,1,17,17,"2016-17",58.5365853658537
"773",2017-02-06,"Los Angeles Clippers",109,"Toronto Raptors",118,19800,1,9,9,"2016-17",65.2173913043478
"774",2017-02-06,"Miami Heat",115,"Minnesota Timberwolves",113,12502,0,-2,2,"2016-17",48.780487804878
"775",2017-02-06,"Phoenix Suns",106,"New Orleans Pelicans",111,15888,1,5,5,"2016-17",51.219512195122
"776",2017-02-06,"Dallas Mavericks",87,"Denver Nuggets",110,13047,1,23,23,"2016-17",53.6585365853659
"777",2017-02-06,"San Antonio Spurs",74,"Memphis Grizzlies",89,16708,1,15,15,"2016-17",59.0909090909091
"778",2017-02-06,"Chicago Bulls",112,"Sacramento Kings",107,17608,0,-5,5,"2016-17",41.4634146341463
"779",2017-02-07,"Brooklyn Nets",107,"Charlotte Hornets",111,15322,1,4,4,"2016-17",53.6585365853659
"780",2017-02-07,"Orlando Magic",104,"Houston Rockets",128,15514,1,24,24,"2016-17",72.3404255319149
"781",2017-02-07,"Portland Trail Blazers",114,"Dallas Mavericks",113,19326,0,-1,1,"2016-17",51.219512195122
"782",2017-02-08,"Cleveland Cavaliers",132,"Indiana Pacers",117,17580,0,-15,15,"2016-17",67.4418604651163
"783",2017-02-08,"San Antonio Spurs",111,"Philadelphia 76ers",103,19233,0,-8,8,"2016-17",41.4634146341463
"784",2017-02-08,"Denver Nuggets",106,"Atlanta Hawks",117,14222,1,11,11,"2016-17",56.8181818181818
"785",2017-02-08,"Washington Wizards",114,"Brooklyn Nets",110,13179,0,-4,4,"2016-17",31.7073170731707
"786",2017-02-08,"Los Angeles Lakers",102,"Detroit Pistons",121,15121,1,19,19,"2016-17",58.5365853658537
"787",2017-02-08,"Phoenix Suns",91,"Memphis Grizzlies",110,16044,1,19,19,"2016-17",59.0909090909091
"788",2017-02-08,"Miami Heat",106,"Milwaukee Bucks",88,14211,0,-18,18,"2016-17",54.5454545454545
"789",2017-02-08,"Toronto Raptors",109,"Minnesota Timberwolves",112,13832,1,3,3,"2016-17",48.780487804878
"790",2017-02-08,"Utah Jazz",127,"New Orleans Pelicans",94,14508,0,-33,33,"2016-17",51.219512195122
"791",2017-02-08,"Los Angeles Clippers",119,"New York Knicks",115,19812,0,-4,4,"2016-17",46.3414634146341
"792",2017-02-08,"Chicago Bulls",92,"Golden State Warriors",123,19596,1,31,31,"2016-17",90
"793",2017-02-08,"Boston Celtics",92,"Sacramento Kings",108,17608,1,16,16,"2016-17",41.4634146341463
"794",2017-02-09,"Houston Rockets",107,"Charlotte Hornets",95,16270,0,-12,12,"2016-17",53.6585365853659
"795",2017-02-09,"Philadelphia 76ers",112,"Orlando Magic",111,17829,0,-1,1,"2016-17",39.0243902439024
"796",2017-02-09,"Cleveland Cavaliers",109,"Oklahoma City Thunder",118,18203,1,9,9,"2016-17",67.4418604651163
"797",2017-02-09,"Utah Jazz",105,"Dallas Mavericks",112,19883,1,7,7,"2016-17",51.219512195122
"798",2017-02-09,"Boston Celtics",120,"Portland Trail Blazers",111,19393,0,-9,9,"2016-17",58.1395348837209
"799",2017-02-10,"Miami Heat",108,"Brooklyn Nets",99,15382,0,-9,9,"2016-17",31.7073170731707
"800",2017-02-10,"San Antonio Spurs",103,"Detroit Pistons",92,17222,0,-11,11,"2016-17",58.5365853658537
"801",2017-02-10,"Denver Nuggets",131,"New York Knicks",123,19812,0,-8,8,"2016-17",46.3414634146341
"802",2017-02-10,"Golden State Warriors",122,"Memphis Grizzlies",107,18119,0,-15,15,"2016-17",59.0909090909091
"803",2017-02-10,"Los Angeles Lakers",122,"Milwaukee Bucks",114,16380,0,-8,8,"2016-17",54.5454545454545
"804",2017-02-10,"New Orleans Pelicans",122,"Minnesota Timberwolves",106,16093,0,-16,16,"2016-17",48.780487804878
"805",2017-02-10,"Indiana Pacers",107,"Washington Wizards",112,19503,1,5,5,"2016-17",76.5957446808511
"806",2017-02-10,"Chicago Bulls",97,"Phoenix Suns",115,18055,1,18,18,"2016-17",36.5853658536585
"807",2017-02-10,"Atlanta Hawks",107,"Sacramento Kings",108,17608,1,1,1,"2016-17",41.4634146341463
"808",2017-02-11,"Los Angeles Clippers",107,"Charlotte Hornets",102,19483,0,-5,5,"2016-17",53.6585365853659
"809",2017-02-11,"Milwaukee Bucks",116,"Indiana Pacers",100,17923,0,-16,16,"2016-17",67.4418604651163
"810",2017-02-11,"Denver Nuggets",109,"Cleveland Cavaliers",125,20562,1,16,16,"2016-17",75.5102040816327
"811",2017-02-11,"Miami Heat",109,"Philadelphia 76ers",117,20698,1,8,8,"2016-17",41.4634146341463
"812",2017-02-11,"Golden State Warriors",130,"Oklahoma City Thunder",114,18203,0,-16,16,"2016-17",67.4418604651163
"813",2017-02-11,"Orlando Magic",80,"Dallas Mavericks",112,20052,1,32,32,"2016-17",51.219512195122
"814",2017-02-11,"Phoenix Suns",102,"Houston Rockets",133,18055,1,31,31,"2016-17",72.3404255319149
"815",2017-02-11,"Boston Celtics",112,"Utah Jazz",104,19911,0,-8,8,"2016-17",65.2173913043478
"816",2017-02-12,"Chicago Bulls",89,"Minnesota Timberwolves",117,19356,1,28,28,"2016-17",48.780487804878
"817",2017-02-12,"San Antonio Spurs",90,"New York Knicks",94,19812,1,4,4,"2016-17",46.3414634146341
"818",2017-02-12,"Detroit Pistons",102,"Toronto Raptors",101,19800,0,-1,1,"2016-17",65.2173913043478
"819",2017-02-12,"New Orleans Pelicans",99,"Sacramento Kings",105,17608,1,6,6,"2016-17",41.4634146341463
"820",2017-02-13,"Philadelphia 76ers",105,"Charlotte Hornets",99,15775,0,-6,6,"2016-17",53.6585365853659
"821",2017-02-13,"San Antonio Spurs",110,"Indiana Pacers",106,15203,0,-4,4,"2016-17",67.4418604651163
"822",2017-02-13,"Memphis Grizzlies",112,"Brooklyn Nets",103,13597,0,-9,9,"2016-17",31.7073170731707
"823",2017-02-13,"Orlando Magic",116,"Miami Heat",107,19600,0,-9,9,"2016-17",56.0975609756098
"824",2017-02-13,"Detroit Pistons",89,"Milwaukee Bucks",102,13397,1,13,13,"2016-17",54.5454545454545
"825",2017-02-13,"Oklahoma City Thunder",98,"Washington Wizards",120,20356,1,22,22,"2016-17",76.5957446808511
"826",2017-02-13,"Boston Celtics",111,"Dallas Mavericks",98,20159,0,-13,13,"2016-17",51.219512195122
"827",2017-02-13,"Golden State Warriors",110,"Denver Nuggets",132,19941,1,22,22,"2016-17",53.6585365853659
"828",2017-02-13,"New Orleans Pelicans",110,"Phoenix Suns",108,16321,0,-2,2,"2016-17",36.5853658536585
"829",2017-02-13,"Los Angeles Clippers",88,"Utah Jazz",72,19521,0,-16,16,"2016-17",65.2173913043478
"830",2017-02-13,"Atlanta Hawks",109,"Portland Trail Blazers",104,19475,0,-5,5,"2016-17",58.1395348837209
"831",2017-02-14,"Toronto Raptors",94,"Chicago Bulls",105,21220,1,11,11,"2016-17",56.8181818181818
"832",2017-02-14,"Cleveland Cavaliers",116,"Minnesota Timberwolves",108,17738,0,-8,8,"2016-17",48.780487804878
"833",2017-02-14,"Sacramento Kings",97,"Los Angeles Lakers",96,19997,0,-1,1,"2016-17",41.4634146341463
"834",2017-02-15,"Indiana Pacers",104,"Cleveland Cavaliers",113,20562,1,9,9,"2016-17",75.5102040816327
"835",2017-02-15,"San Antonio Spurs",107,"Orlando Magic",79,17101,0,-28,28,"2016-17",39.0243902439024
"836",2017-02-15,"Philadelphia 76ers",108,"Boston Celtics",116,18624,1,8,8,"2016-17",68.6274509803922
"837",2017-02-15,"Milwaukee Bucks",129,"Brooklyn Nets",125,16182,0,-4,4,"2016-17",31.7073170731707
"838",2017-02-15,"Dallas Mavericks",91,"Detroit Pistons",98,13549,1,7,7,"2016-17",58.5365853658537
"839",2017-02-15,"Charlotte Hornets",85,"Toronto Raptors",90,19800,1,5,5,"2016-17",65.2173913043478
"840",2017-02-15,"Miami Heat",117,"Houston Rockets",109,16967,0,-8,8,"2016-17",72.3404255319149
"841",2017-02-15,"New Orleans Pelicans",95,"Memphis Grizzlies",91,16145,0,-4,4,"2016-17",59.0909090909091
"842",2017-02-15,"Minnesota Timberwolves",112,"Denver Nuggets",99,13924,0,-13,13,"2016-17",53.6585365853659
"843",2017-02-15,"Los Angeles Lakers",101,"Phoenix Suns",137,18055,1,36,36,"2016-17",36.5853658536585
"844",2017-02-15,"Portland Trail Blazers",88,"Utah Jazz",111,19590,1,23,23,"2016-17",65.2173913043478
"845",2017-02-15,"New York Knicks",105,"Oklahoma City Thunder",116,18203,1,11,11,"2016-17",67.4418604651163
"846",2017-02-15,"Sacramento Kings",86,"Golden State Warriors",109,19596,1,23,23,"2016-17",90
"847",2017-02-15,"Atlanta Hawks",84,"Los Angeles Clippers",99,19060,1,15,15,"2016-17",66.6666666666667
"848",2017-02-16,"Washington Wizards",111,"Indiana Pacers",98,17233,0,-13,13,"2016-17",67.4418604651163
"849",2017-02-16,"Boston Celtics",103,"Chicago Bulls",104,21866,1,1,1,"2016-17",56.8181818181818
"850",2017-02-23,"Portland Trail Blazers",112,"Orlando Magic",103,17487,0,-9,9,"2016-17",39.0243902439024
"851",2017-02-23,"Charlotte Hornets",108,"Detroit Pistons",114,14913,1,6,6,"2016-17",58.5365853658537
"852",2017-02-23,"New York Knicks",104,"Cleveland Cavaliers",119,20562,1,15,15,"2016-17",75.5102040816327
"853",2017-02-23,"Houston Rockets",129,"New Orleans Pelicans",99,18470,0,-30,30,"2016-17",51.219512195122
"854",2017-02-23,"Los Angeles Clippers",113,"Golden State Warriors",123,19596,1,10,10,"2016-17",90
"855",2017-02-23,"Denver Nuggets",100,"Sacramento Kings",116,17608,1,16,16,"2016-17",41.4634146341463
"856",2017-02-24,"Memphis Grizzlies",92,"Indiana Pacers",102,17923,1,10,10,"2016-17",67.4418604651163
"857",2017-02-24,"Washington Wizards",112,"Philadelphia 76ers",120,19277,1,8,8,"2016-17",41.4634146341463
"858",2017-02-24,"Miami Heat",108,"Atlanta Hawks",90,18122,0,-18,18,"2016-17",56.8181818181818
"859",2017-02-24,"Phoenix Suns",121,"Chicago Bulls",128,21641,1,7,7,"2016-17",56.8181818181818
"860",2017-02-24,"Utah Jazz",109,"Milwaukee Bucks",95,16064,0,-14,14,"2016-17",54.5454545454545
"861",2017-02-24,"Dallas Mavericks",84,"Minnesota Timberwolves",97,15948,1,13,13,"2016-17",48.780487804878
"862",2017-02-24,"Los Angeles Lakers",93,"Oklahoma City Thunder",110,18203,1,17,17,"2016-17",67.4418604651163
"863",2017-02-24,"Boston Celtics",97,"Toronto Raptors",107,19800,1,10,10,"2016-17",65.2173913043478
"864",2017-02-24,"Brooklyn Nets",109,"Denver Nuggets",129,17143,1,20,20,"2016-17",53.6585365853659
"865",2017-02-24,"San Antonio Spurs",105,"Los Angeles Clippers",97,19060,0,-8,8,"2016-17",66.6666666666667
"866",2017-02-25,"Charlotte Hornets",99,"Sacramento Kings",85,17608,0,-14,14,"2016-17",41.4634146341463
"867",2017-02-25,"Atlanta Hawks",86,"Orlando Magic",105,18498,1,19,19,"2016-17",39.0243902439024
"868",2017-02-25,"Philadelphia 76ers",109,"New York Knicks",110,19812,1,1,1,"2016-17",46.3414634146341
"869",2017-02-25,"Indiana Pacers",95,"Miami Heat",113,19600,1,18,18,"2016-17",56.0975609756098
"870",2017-02-25,"Chicago Bulls",117,"Cleveland Cavaliers",99,20562,0,-18,18,"2016-17",75.5102040816327
"871",2017-02-25,"New Orleans Pelicans",83,"Dallas Mavericks",96,20411,1,13,13,"2016-17",51.219512195122
"872",2017-02-25,"Minnesota Timberwolves",130,"Houston Rockets",142,18055,1,12,12,"2016-17",72.3404255319149
"873",2017-02-25,"Brooklyn Nets",95,"Golden State Warriors",112,19596,1,17,17,"2016-17",90
"874",2017-02-26,"San Antonio Spurs",119,"Los Angeles Lakers",98,18997,0,-21,21,"2016-17",41.4634146341463
"875",2017-02-26,"Phoenix Suns",96,"Milwaukee Bucks",100,16051,1,4,4,"2016-17",54.5454545454545
"876",2017-02-26,"Memphis Grizzlies",105,"Denver Nuggets",98,18024,0,-7,7,"2016-17",53.6585365853659
"877",2017-02-26,"Utah Jazz",102,"Washington Wizards",92,19648,0,-10,10,"2016-17",76.5957446808511
"878",2017-02-26,"Boston Celtics",104,"Detroit Pistons",98,20141,0,-6,6,"2016-17",58.5365853658537
"879",2017-02-26,"Portland Trail Blazers",106,"Toronto Raptors",112,19800,1,6,6,"2016-17",65.2173913043478
"880",2017-02-26,"New Orleans Pelicans",110,"Oklahoma City Thunder",118,18203,1,8,8,"2016-17",67.4418604651163
"881",2017-02-26,"Charlotte Hornets",121,"Los Angeles Clippers",124,19060,1,3,3,"2016-17",66.6666666666667
"882",2017-02-27,"Milwaukee Bucks",95,"Cleveland Cavaliers",102,20562,1,7,7,"2016-17",75.5102040816327
"883",2017-02-27,"Toronto Raptors",92,"New York Knicks",91,19812,0,-1,1,"2016-17",46.3414634146341
"884",2017-02-27,"Golden State Warriors",119,"Philadelphia 76ers",108,20585,0,-11,11,"2016-17",41.4634146341463
"885",2017-02-27,"Atlanta Hawks",114,"Boston Celtics",98,18624,0,-16,16,"2016-17",68.6274509803922
"886",2017-02-27,"Miami Heat",89,"Dallas Mavericks",96,19539,1,7,7,"2016-17",51.219512195122
"887",2017-02-27,"Indiana Pacers",117,"Houston Rockets",108,18055,0,-9,9,"2016-17",72.3404255319149
"888",2017-02-27,"Minnesota Timberwolves",102,"Sacramento Kings",88,17608,0,-14,14,"2016-17",41.4634146341463
"889",2017-02-28,"Golden State Warriors",108,"Washington Wizards",112,20356,1,4,4,"2016-17",76.5957446808511
"890",2017-02-28,"Portland Trail Blazers",113,"Detroit Pistons",120,13502,1,7,7,"2016-17",58.5365853658537
"891",2017-02-28,"Denver Nuggets",125,"Chicago Bulls",107,21015,0,-18,18,"2016-17",56.8181818181818
"892",2017-02-28,"Phoenix Suns",112,"Memphis Grizzlies",130,15871,1,18,18,"2016-17",59.0909090909091
"893",2017-02-28,"Utah Jazz",106,"Oklahoma City Thunder",109,18203,1,3,3,"2016-17",67.4418604651163
"894",2017-02-28,"Charlotte Hornets",109,"Los Angeles Lakers",104,18997,0,-5,5,"2016-17",41.4634146341463
"895",2017-03-01,"New York Knicks",101,"Orlando Magic",90,16005,0,-11,11,"2016-17",39.0243902439024
"896",2017-03-01,"Dallas Mavericks",95,"Atlanta Hawks",100,12483,1,5,5,"2016-17",56.8181818181818
"897",2017-03-01,"Philadelphia 76ers",98,"Miami Heat",125,19609,1,27,27,"2016-17",56.0975609756098
"898",2017-03-01,"Washington Wizards",105,"Toronto Raptors",96,19800,0,-9,9,"2016-17",65.2173913043478
"899",2017-03-01,"Cleveland Cavaliers",99,"Boston Celtics",103,18624,1,4,4,"2016-17",68.6274509803922
"900",2017-03-01,"Denver Nuggets",110,"Milwaukee Bucks",98,13214,0,-12,12,"2016-17",54.5454545454545
"901",2017-03-01,"Detroit Pistons",86,"New Orleans Pelicans",109,14406,1,23,23,"2016-17",51.219512195122
"902",2017-03-01,"Indiana Pacers",99,"San Antonio Spurs",100,18418,1,1,1,"2016-17",73.469387755102
"903",2017-03-01,"Minnesota Timberwolves",107,"Utah Jazz",80,19127,0,-27,27,"2016-17",65.2173913043478
"904",2017-03-01,"Houston Rockets",122,"Los Angeles Clippers",103,19060,0,-19,19,"2016-17",66.6666666666667
"905",2017-03-01,"Brooklyn Nets",109,"Sacramento Kings",100,17608,0,-9,9,"2016-17",41.4634146341463
"906",2017-03-02,"Golden State Warriors",87,"Chicago Bulls",94,22253,1,7,7,"2016-17",56.8181818181818
"907",2017-03-02,"Charlotte Hornets",103,"Phoenix Suns",120,16572,1,17,17,"2016-17",36.5853658536585
"908",2017-03-02,"Oklahoma City Thunder",109,"Portland Trail Blazers",114,19875,1,5,5,"2016-17",58.1395348837209
"909",2017-03-03,"Cleveland Cavaliers",135,"Atlanta Hawks",130,18877,0,-5,5,"2016-17",56.8181818181818
"910",2017-03-03,"Miami Heat",99,"Orlando Magic",110,17136,1,11,11,"2016-17",39.0243902439024
"911",2017-03-03,"New York Knicks",102,"Philadelphia 76ers",105,18518,1,3,3,"2016-17",41.4634146341463
"912",2017-03-03,"Toronto Raptors",114,"Washington Wizards",106,20356,0,-8,8,"2016-17",76.5957446808511
"913",2017-03-03,"Los Angeles Clippers",101,"Milwaukee Bucks",112,16208,1,11,11,"2016-17",54.5454545454545
"914",2017-03-03,"Memphis Grizzlies",100,"Dallas Mavericks",104,19480,1,4,4,"2016-17",51.219512195122
"915",2017-03-03,"Oklahoma City Thunder",111,"Phoenix Suns",118,18055,1,7,7,"2016-17",36.5853658536585
"916",2017-03-03,"Brooklyn Nets",97,"Utah Jazz",112,19911,1,15,15,"2016-17",65.2173913043478
"917",2017-03-03,"San Antonio Spurs",101,"New Orleans Pelicans",98,17669,0,-3,3,"2016-17",51.219512195122
"918",2017-03-03,"Boston Celtics",115,"Los Angeles Lakers",95,18997,0,-20,20,"2016-17",41.4634146341463
"919",2017-03-04,"Detroit Pistons",136,"Philadelphia 76ers",106,19523,0,-30,30,"2016-17",41.4634146341463
"920",2017-03-04,"Cleveland Cavaliers",92,"Miami Heat",120,19600,1,28,28,"2016-17",56.0975609756098
"921",2017-03-04,"Toronto Raptors",94,"Milwaukee Bucks",101,16775,1,7,7,"2016-17",54.5454545454545
"922",2017-03-04,"Los Angeles Clippers",101,"Chicago Bulls",91,22807,0,-10,10,"2016-17",56.8181818181818
"923",2017-03-04,"Charlotte Hornets",112,"Denver Nuggets",102,14708,0,-10,10,"2016-17",53.6585365853659
"924",2017-03-04,"Memphis Grizzlies",108,"Houston Rockets",123,18055,1,15,15,"2016-17",72.3404255319149
"925",2017-03-04,"Minnesota Timberwolves",90,"San Antonio Spurs",97,18418,1,7,7,"2016-17",73.469387755102
"926",2017-03-04,"Brooklyn Nets",116,"Portland Trail Blazers",130,19638,1,14,14,"2016-17",58.1395348837209
"927",2017-03-05,"Indiana Pacers",97,"Atlanta Hawks",96,15366,0,-1,1,"2016-17",56.8181818181818
"928",2017-03-05,"Golden State Warriors",112,"New York Knicks",105,19812,0,-7,7,"2016-17",46.3414634146341
"929",2017-03-05,"Boston Celtics",106,"Phoenix Suns",109,16790,1,3,3,"2016-17",36.5853658536585
"930",2017-03-05,"Orlando Magic",114,"Washington Wizards",115,19195,1,1,1,"2016-17",76.5957446808511
"931",2017-03-05,"Utah Jazz",110,"Sacramento Kings",109,17608,0,-1,1,"2016-17",41.4634146341463
"932",2017-03-05,"Oklahoma City Thunder",89,"Dallas Mavericks",104,20232,1,15,15,"2016-17",51.219512195122
"933",2017-03-05,"New Orleans Pelicans",105,"Los Angeles Lakers",97,18997,0,-8,8,"2016-17",41.4634146341463
"934",2017-03-06,"Miami Heat",106,"Cleveland Cavaliers",98,20562,0,-8,8,"2016-17",75.5102040816327
"935",2017-03-06,"New York Knicks",113,"Orlando Magic",105,16046,0,-8,8,"2016-17",39.0243902439024
"936",2017-03-06,"Milwaukee Bucks",112,"Philadelphia 76ers",98,18351,0,-14,14,"2016-17",41.4634146341463
"937",2017-03-06,"Golden State Warriors",119,"Atlanta Hawks",111,18890,0,-8,8,"2016-17",56.8181818181818
"938",2017-03-06,"Chicago Bulls",95,"Detroit Pistons",109,16039,1,14,14,"2016-17",58.5365853658537
"939",2017-03-06,"Indiana Pacers",88,"Charlotte Hornets",100,16387,1,12,12,"2016-17",53.6585365853659
"940",2017-03-06,"Brooklyn Nets",122,"Memphis Grizzlies",109,15505,0,-13,13,"2016-17",59.0909090909091
"941",2017-03-06,"Houston Rockets",110,"San Antonio Spurs",112,18418,1,2,2,"2016-17",73.469387755102
"942",2017-03-06,"Sacramento Kings",96,"Denver Nuggets",108,11614,1,12,12,"2016-17",53.6585365853659
"943",2017-03-06,"New Orleans Pelicans",83,"Utah Jazz",88,19649,1,5,5,"2016-17",65.2173913043478
"944",2017-03-06,"Boston Celtics",102,"Los Angeles Clippers",116,19283,1,14,14,"2016-17",66.6666666666667
"945",2017-03-07,"Portland Trail Blazers",126,"Oklahoma City Thunder",121,18203,0,-5,5,"2016-17",67.4418604651163
"946",2017-03-07,"Los Angeles Lakers",111,"Dallas Mavericks",122,20484,1,11,11,"2016-17",51.219512195122
"947",2017-03-07,"Washington Wizards",131,"Phoenix Suns",127,16372,0,-4,4,"2016-17",36.5853658536585
"948",2017-03-08,"Chicago Bulls",91,"Orlando Magic",98,16063,1,7,7,"2016-17",39.0243902439024
"949",2017-03-08,"Brooklyn Nets",105,"Atlanta Hawks",110,11931,1,5,5,"2016-17",56.8181818181818
"950",2017-03-08,"Charlotte Hornets",101,"Miami Heat",108,19600,1,7,7,"2016-17",56.0975609756098
"951",2017-03-08,"Utah Jazz",115,"Houston Rockets",108,16230,0,-7,7,"2016-17",72.3404255319149
"952",2017-03-08,"Detroit Pistons",98,"Indiana Pacers",115,14353,1,17,17,"2016-17",67.4418604651163
"953",2017-03-08,"New York Knicks",93,"Milwaukee Bucks",104,13767,1,11,11,"2016-17",54.5454545454545
"954",2017-03-08,"Los Angeles Clippers",91,"Minnesota Timberwolves",107,14933,1,16,16,"2016-17",48.780487804878
"955",2017-03-08,"Toronto Raptors",94,"New Orleans Pelicans",87,14543,0,-7,7,"2016-17",51.219512195122
"956",2017-03-08,"Sacramento Kings",104,"San Antonio Spurs",114,18418,1,10,10,"2016-17",73.469387755102
"957",2017-03-08,"Washington Wizards",123,"Denver Nuggets",113,12323,0,-10,10,"2016-17",53.6585365853659
"958",2017-03-08,"Boston Celtics",99,"Golden State Warriors",86,19596,0,-13,13,"2016-17",90
"959",2017-03-09,"Cleveland Cavaliers",101,"Detroit Pistons",106,19421,1,5,5,"2016-17",58.5365853658537
"960",2017-03-09,"Los Angeles Clippers",114,"Memphis Grizzlies",98,16642,0,-16,16,"2016-17",59.0909090909091
"961",2017-03-09,"San Antonio Spurs",92,"Oklahoma City Thunder",102,18203,1,10,10,"2016-17",67.4418604651163
"962",2017-03-09,"Philadelphia 76ers",108,"Portland Trail Blazers",114,19240,1,6,6,"2016-17",58.1395348837209
"963",2017-03-09,"Los Angeles Lakers",122,"Phoenix Suns",110,17552,0,-12,12,"2016-17",36.5853658536585
"964",2017-03-10,"Orlando Magic",81,"Charlotte Hornets",121,17444,1,40,40,"2016-17",53.6585365853659
"965",2017-03-10,"Toronto Raptors",99,"Atlanta Hawks",105,16078,1,6,6,"2016-17",56.8181818181818
"966",2017-03-10,"Houston Rockets",115,"Chicago Bulls",94,21995,0,-21,21,"2016-17",56.8181818181818
"967",2017-03-10,"Indiana Pacers",85,"Milwaukee Bucks",99,16177,1,14,14,"2016-17",54.5454545454545
"968",2017-03-10,"Golden State Warriors",102,"Minnesota Timberwolves",103,20412,1,1,1,"2016-17",48.780487804878
"969",2017-03-10,"Brooklyn Nets",96,"Dallas Mavericks",105,20022,1,9,9,"2016-17",51.219512195122
"970",2017-03-10,"Boston Celtics",99,"Denver Nuggets",119,17147,1,20,20,"2016-17",53.6585365853659
"971",2017-03-10,"Washington Wizards",130,"Sacramento Kings",122,17608,0,-8,8,"2016-17",41.4634146341463
"972",2017-03-11,"Utah Jazz",104,"Oklahoma City Thunder",112,18203,1,8,8,"2016-17",67.4418604651163
"973",2017-03-11,"Philadelphia 76ers",100,"Los Angeles Clippers",112,19060,1,12,12,"2016-17",66.6666666666667
"974",2017-03-11,"New York Knicks",92,"Detroit Pistons",112,19607,1,20,20,"2016-17",58.5365853658537
"975",2017-03-11,"New Orleans Pelicans",125,"Charlotte Hornets",122,18196,0,-3,3,"2016-17",53.6585365853659
"976",2017-03-11,"Cleveland Cavaliers",116,"Orlando Magic",104,18846,0,-12,12,"2016-17",39.0243902439024
"977",2017-03-11,"Toronto Raptors",89,"Miami Heat",104,19745,1,15,15,"2016-17",56.0975609756098
"978",2017-03-11,"Minnesota Timberwolves",95,"Milwaukee Bucks",102,18717,1,7,7,"2016-17",54.5454545454545
"979",2017-03-11,"Golden State Warriors",85,"San Antonio Spurs",107,18418,1,22,22,"2016-17",73.469387755102
"980",2017-03-11,"Phoenix Suns",100,"Dallas Mavericks",98,20324,0,-2,2,"2016-17",51.219512195122
"981",2017-03-11,"Atlanta Hawks",107,"Memphis Grizzlies",90,17523,0,-17,17,"2016-17",59.0909090909091
"982",2017-03-11,"Washington Wizards",125,"Portland Trail Blazers",124,19482,0,-1,1,"2016-17",58.1395348837209
"983",2017-03-11,"Denver Nuggets",105,"Sacramento Kings",92,17608,0,-13,13,"2016-17",41.4634146341463
"984",2017-03-12,"Chicago Bulls",80,"Boston Celtics",100,18624,1,20,20,"2016-17",68.6274509803922
"985",2017-03-12,"New York Knicks",112,"Brooklyn Nets",120,17732,1,8,8,"2016-17",31.7073170731707
"986",2017-03-12,"Miami Heat",98,"Indiana Pacers",102,17923,1,4,4,"2016-17",67.4418604651163
"987",2017-03-12,"Cleveland Cavaliers",112,"Houston Rockets",117,18055,1,5,5,"2016-17",72.3404255319149
"988",2017-03-12,"Portland Trail Blazers",110,"Phoenix Suns",101,16664,0,-9,9,"2016-17",36.5853658536585
"989",2017-03-12,"Philadelphia 76ers",118,"Los Angeles Lakers",116,18997,0,-2,2,"2016-17",41.4634146341463
"990",2017-03-13,"Chicago Bulls",115,"Charlotte Hornets",109,16489,0,-6,6,"2016-17",53.6585365853659
"991",2017-03-13,"Dallas Mavericks",78,"Toronto Raptors",100,19800,1,22,22,"2016-17",65.2173913043478
"992",2017-03-13,"Milwaukee Bucks",93,"Memphis Grizzlies",113,16770,1,20,20,"2016-17",59.0909090909091
"993",2017-03-13,"Washington Wizards",104,"Minnesota Timberwolves",119,15747,1,15,15,"2016-17",48.780487804878
"994",2017-03-13,"Atlanta Hawks",99,"San Antonio Spurs",107,18418,1,8,8,"2016-17",73.469387755102
"995",2017-03-13,"Los Angeles Clippers",108,"Utah Jazz",114,19911,1,6,6,"2016-17",65.2173913043478
"996",2017-03-13,"Los Angeles Lakers",101,"Denver Nuggets",129,17344,1,28,28,"2016-17",53.6585365853659
"997",2017-03-13,"Orlando Magic",115,"Sacramento Kings",120,17608,1,5,5,"2016-17",41.4634146341463
"998",2017-03-14,"Detroit Pistons",96,"Cleveland Cavaliers",128,20562,1,32,32,"2016-17",75.5102040816327
"999",2017-03-14,"Oklahoma City Thunder",122,"Brooklyn Nets",104,13911,0,-18,18,"2016-17",31.7073170731707
"1000",2017-03-14,"Indiana Pacers",81,"New York Knicks",87,18261,1,6,6,"2016-17",46.3414634146341
"1001",2017-03-14,"Portland Trail Blazers",77,"New Orleans Pelicans",100,15530,1,23,23,"2016-17",51.219512195122
"1002",2017-03-14,"Philadelphia 76ers",104,"Golden State Warriors",106,19596,1,2,2,"2016-17",90
"1003",2017-03-15,"Charlotte Hornets",77,"Indiana Pacers",98,14169,1,21,21,"2016-17",67.4418604651163
"1004",2017-03-15,"Dallas Mavericks",112,"Washington Wizards",107,17844,0,-5,5,"2016-17",76.5957446808511
"1005",2017-03-15,"Minnesota Timberwolves",104,"Boston Celtics",117,18624,1,13,13,"2016-17",68.6274509803922
"1006",2017-03-15,"Utah Jazz",97,"Detroit Pistons",83,14033,0,-14,14,"2016-17",58.5365853658537
"1007",2017-03-15,"New Orleans Pelicans",112,"Miami Heat",120,19678,1,8,8,"2016-17",56.0975609756098
"1008",2017-03-15,"Memphis Grizzlies",98,"Chicago Bulls",91,21583,0,-7,7,"2016-17",56.8181818181818
"1009",2017-03-15,"Los Angeles Lakers",100,"Houston Rockets",139,18055,1,39,39,"2016-17",72.3404255319149
"1010",2017-03-15,"Portland Trail Blazers",110,"San Antonio Spurs",106,18418,0,-4,4,"2016-17",73.469387755102
"1011",2017-03-15,"Sacramento Kings",107,"Phoenix Suns",101,17196,0,-6,6,"2016-17",36.5853658536585
"1012",2017-03-15,"Milwaukee Bucks",97,"Los Angeles Clippers",96,19060,0,-1,1,"2016-17",66.6666666666667
"1013",2017-03-16,"Utah Jazz",83,"Cleveland Cavaliers",91,20562,1,8,8,"2016-17",75.5102040816327
"1014",2017-03-16,"Oklahoma City Thunder",123,"Toronto Raptors",102,19800,0,-21,21,"2016-17",65.2173913043478
"1015",2017-03-16,"Memphis Grizzlies",103,"Atlanta Hawks",91,17063,0,-12,12,"2016-17",56.8181818181818
"1016",2017-03-16,"Brooklyn Nets",121,"New York Knicks",110,19812,0,-11,11,"2016-17",46.3414634146341
"1017",2017-03-16,"Los Angeles Clippers",114,"Denver Nuggets",129,14179,1,15,15,"2016-17",53.6585365853659
"1018",2017-03-16,"Orlando Magic",92,"Golden State Warriors",122,19596,1,30,30,"2016-17",90
"1019",2017-03-17,"Dallas Mavericks",74,"Philadelphia 76ers",116,17642,1,42,42,"2016-17",41.4634146341463
"1020",2017-03-17,"Chicago Bulls",107,"Washington Wizards",112,20356,1,5,5,"2016-17",76.5957446808511
"1021",2017-03-17,"Boston Celtics",98,"Brooklyn Nets",95,17732,0,-3,3,"2016-17",31.7073170731707
"1022",2017-03-17,"Toronto Raptors",87,"Detroit Pistons",75,16541,0,-12,12,"2016-17",58.5365853658537
"1023",2017-03-17,"Minnesota Timberwolves",105,"Miami Heat",123,19600,1,18,18,"2016-17",56.0975609756098
"1024",2017-03-17,"Houston Rockets",112,"New Orleans Pelicans",128,17972,1,16,16,"2016-17",51.219512195122
"1025",2017-03-17,"Orlando Magic",109,"Phoenix Suns",103,16880,0,-6,6,"2016-17",36.5853658536585
"1026",2017-03-17,"Milwaukee Bucks",107,"Los Angeles Lakers",103,18997,0,-4,4,"2016-17",41.4634146341463
"1027",2017-03-18,"Sacramento Kings",94,"Oklahoma City Thunder",110,18203,1,16,16,"2016-17",67.4418604651163
"1028",2017-03-18,"Portland Trail Blazers",113,"Atlanta Hawks",97,16543,0,-16,16,"2016-17",56.8181818181818
"1029",2017-03-18,"Washington Wizards",93,"Charlotte Hornets",98,19361,1,5,5,"2016-17",53.6585365853659
"1030",2017-03-18,"Cleveland Cavaliers",78,"Los Angeles Clippers",108,19379,1,30,30,"2016-17",66.6666666666667
"1031",2017-03-18,"Utah Jazz",86,"Chicago Bulls",95,21953,1,9,9,"2016-17",56.8181818181818
"1032",2017-03-18,"San Antonio Spurs",96,"Memphis Grizzlies",104,18119,1,8,8,"2016-17",59.0909090909091
"1033",2017-03-18,"Houston Rockets",109,"Denver Nuggets",105,17512,0,-4,4,"2016-17",53.6585365853659
"1034",2017-03-18,"Milwaukee Bucks",92,"Golden State Warriors",117,19596,1,25,25,"2016-17",90
"1035",2017-03-19,"Dallas Mavericks",111,"Brooklyn Nets",104,14045,0,-7,7,"2016-17",31.7073170731707
"1036",2017-03-19,"Boston Celtics",99,"Philadelphia 76ers",105,19446,1,6,6,"2016-17",41.4634146341463
"1037",2017-03-19,"Phoenix Suns",95,"Detroit Pistons",112,19588,1,17,17,"2016-17",58.5365853658537
"1038",2017-03-19,"Portland Trail Blazers",115,"Miami Heat",104,19600,0,-11,11,"2016-17",56.0975609756098
"1039",2017-03-19,"Minnesota Timberwolves",109,"New Orleans Pelicans",123,16111,1,14,14,"2016-17",51.219512195122
"1040",2017-03-19,"Indiana Pacers",91,"Toronto Raptors",116,19800,1,25,25,"2016-17",65.2173913043478
"1041",2017-03-19,"Sacramento Kings",102,"San Antonio Spurs",118,18418,1,16,16,"2016-17",73.469387755102
"1042",2017-03-19,"Cleveland Cavaliers",125,"Los Angeles Lakers",120,18997,0,-5,5,"2016-17",41.4634146341463
"1043",2017-03-20,"Atlanta Hawks",90,"Charlotte Hornets",105,14278,1,15,15,"2016-17",53.6585365853659
"1044",2017-03-20,"Utah Jazz",100,"Indiana Pacers",107,15458,1,7,7,"2016-17",67.4418604651163
"1045",2017-03-20,"Philadelphia 76ers",109,"Orlando Magic",112,16236,1,3,3,"2016-17",39.0243902439024
"1046",2017-03-20,"Washington Wizards",102,"Boston Celtics",110,18624,1,8,8,"2016-17",68.6274509803922
"1047",2017-03-20,"Denver Nuggets",124,"Houston Rockets",125,16080,1,1,1,"2016-17",72.3404255319149
"1048",2017-03-20,"Golden State Warriors",111,"Oklahoma City Thunder",95,18203,0,-16,16,"2016-17",67.4418604651163
"1049",2017-03-20,"New York Knicks",105,"Los Angeles Clippers",114,19060,1,9,9,"2016-17",66.6666666666667
"1050",2017-03-21,"Chicago Bulls",120,"Toronto Raptors",122,19800,1,2,2,"2016-17",65.2173913043478
"1051",2017-03-21,"Detroit Pistons",96,"Brooklyn Nets",98,14343,1,2,2,"2016-17",31.7073170731707
"1052",2017-03-21,"Phoenix Suns",97,"Miami Heat",112,19600,1,15,15,"2016-17",56.0975609756098
"1053",2017-03-21,"Memphis Grizzlies",82,"New Orleans Pelicans",95,15973,1,13,13,"2016-17",51.219512195122
"1054",2017-03-21,"Golden State Warriors",112,"Dallas Mavericks",87,20453,0,-25,25,"2016-17",51.219512195122
"1055",2017-03-21,"San Antonio Spurs",100,"Minnesota Timberwolves",93,13742,0,-7,7,"2016-17",48.780487804878
"1056",2017-03-21,"Milwaukee Bucks",93,"Portland Trail Blazers",90,19525,0,-3,3,"2016-17",58.1395348837209
"1057",2017-03-21,"Los Angeles Clippers",133,"Los Angeles Lakers",109,18724,0,-24,24,"2016-17",41.4634146341463
"1058",2017-03-22,"Charlotte Hornets",109,"Orlando Magic",102,16034,0,-7,7,"2016-17",39.0243902439024
"1059",2017-03-22,"Indiana Pacers",100,"Boston Celtics",109,18624,1,9,9,"2016-17",68.6274509803922
"1060",2017-03-22,"Detroit Pistons",95,"Chicago Bulls",117,21503,1,22,22,"2016-17",56.8181818181818
"1061",2017-03-22,"Philadelphia 76ers",97,"Oklahoma City Thunder",122,18203,1,25,25,"2016-17",67.4418604651163
"1062",2017-03-22,"Atlanta Hawks",100,"Washington Wizards",104,18137,1,4,4,"2016-17",76.5957446808511
"1063",2017-03-22,"Cleveland Cavaliers",113,"Denver Nuggets",126,19718,1,13,13,"2016-17",53.6585365853659
"1064",2017-03-22,"Milwaukee Bucks",116,"Sacramento Kings",98,17608,0,-18,18,"2016-17",41.4634146341463
"1065",2017-03-22,"New York Knicks",101,"Utah Jazz",108,19911,1,7,7,"2016-17",65.2173913043478
"1066",2017-03-23,"Phoenix Suns",98,"Brooklyn Nets",126,15141,1,28,28,"2016-17",31.7073170731707
"1067",2017-03-23,"Toronto Raptors",101,"Miami Heat",84,19745,0,-17,17,"2016-17",56.0975609756098
"1068",2017-03-23,"Los Angeles Clippers",95,"Dallas Mavericks",97,19703,1,2,2,"2016-17",51.219512195122
"1069",2017-03-23,"Memphis Grizzlies",90,"San Antonio Spurs",97,18418,1,7,7,"2016-17",73.469387755102
"1070",2017-03-23,"New York Knicks",95,"Portland Trail Blazers",110,19020,1,15,15,"2016-17",58.1395348837209
"1071",2017-03-24,"Cleveland Cavaliers",112,"Charlotte Hornets",105,19511,0,-7,7,"2016-17",53.6585365853659
"1072",2017-03-24,"Denver Nuggets",125,"Indiana Pacers",117,17923,0,-8,8,"2016-17",67.4418604651163
"1073",2017-03-24,"Detroit Pistons",87,"Orlando Magic",115,18076,1,28,28,"2016-17",39.0243902439024
"1074",2017-03-24,"Brooklyn Nets",108,"Washington Wizards",129,19616,1,21,21,"2016-17",76.5957446808511
"1075",2017-03-24,"Phoenix Suns",120,"Boston Celtics",130,18624,1,10,10,"2016-17",68.6274509803922
"1076",2017-03-24,"Philadelphia 76ers",117,"Chicago Bulls",107,21558,0,-10,10,"2016-17",56.8181818181818
"1077",2017-03-24,"New Orleans Pelicans",107,"Houston Rockets",117,18055,1,10,10,"2016-17",72.3404255319149
"1078",2017-03-24,"Atlanta Hawks",97,"Milwaukee Bucks",100,16786,1,3,3,"2016-17",54.5454545454545
"1079",2017-03-24,"Sacramento Kings",100,"Golden State Warriors",114,19596,1,14,14,"2016-17",90
"1080",2017-03-24,"Minnesota Timberwolves",119,"Los Angeles Lakers",130,18997,1,11,11,"2016-17",41.4634146341463
"1081",2017-03-25,"Utah Jazz",95,"Los Angeles Clippers",108,19060,1,13,13,"2016-17",66.6666666666667
"1082",2017-03-25,"Washington Wizards",127,"Cleveland Cavaliers",115,20562,0,-12,12,"2016-17",75.5102040816327
"1083",2017-03-25,"Toronto Raptors",94,"Dallas Mavericks",86,19934,0,-8,8,"2016-17",51.219512195122
"1084",2017-03-25,"New York Knicks",98,"San Antonio Spurs",106,18418,1,8,8,"2016-17",73.469387755102
"1085",2017-03-25,"Minnesota Timberwolves",100,"Portland Trail Blazers",112,19580,1,12,12,"2016-17",58.1395348837209
"1086",2017-03-26,"Brooklyn Nets",107,"Atlanta Hawks",92,15921,0,-15,15,"2016-17",56.8181818181818
"1087",2017-03-26,"Phoenix Suns",106,"Charlotte Hornets",120,17292,1,14,14,"2016-17",53.6585365853659
"1088",2017-03-26,"Oklahoma City Thunder",125,"Houston Rockets",137,18055,1,12,12,"2016-17",72.3404255319149
"1089",2017-03-26,"Sacramento Kings",98,"Los Angeles Clippers",97,19060,0,-1,1,"2016-17",66.6666666666667
"1090",2017-03-26,"Chicago Bulls",109,"Milwaukee Bucks",94,17669,0,-15,15,"2016-17",54.5454545454545
"1091",2017-03-26,"Miami Heat",108,"Boston Celtics",112,18624,1,4,4,"2016-17",68.6274509803922
"1092",2017-03-26,"Philadelphia 76ers",94,"Indiana Pacers",107,16467,1,13,13,"2016-17",67.4418604651163
"1093",2017-03-26,"New Orleans Pelicans",115,"Denver Nuggets",90,19850,0,-25,25,"2016-17",53.6585365853659
"1094",2017-03-26,"Memphis Grizzlies",94,"Golden State Warriors",106,19596,1,12,12,"2016-17",90
"1095",2017-03-26,"Portland Trail Blazers",97,"Los Angeles Lakers",81,18698,0,-16,16,"2016-17",41.4634146341463
"1096",2017-03-27,"Detroit Pistons",95,"New York Knicks",109,19812,1,14,14,"2016-17",46.3414634146341
"1097",2017-03-27,"Orlando Magic",112,"Toronto Raptors",131,19800,1,19,19,"2016-17",65.2173913043478
"1098",2017-03-27,"Cleveland Cavaliers",74,"San Antonio Spurs",103,18418,1,29,29,"2016-17",73.469387755102
"1099",2017-03-27,"Oklahoma City Thunder",92,"Dallas Mavericks",91,19970,0,-1,1,"2016-17",51.219512195122
"1100",2017-03-27,"Memphis Grizzlies",90,"Sacramento Kings",91,17608,1,1,1,"2016-17",41.4634146341463
"1101",2017-03-27,"New Orleans Pelicans",100,"Utah Jazz",108,18924,1,8,8,"2016-17",65.2173913043478
"1102",2017-03-28,"Milwaukee Bucks",118,"Charlotte Hornets",108,16505,0,-10,10,"2016-17",53.6585365853659
"1103",2017-03-28,"Minnesota Timberwolves",115,"Indiana Pacers",114,17534,0,-1,1,"2016-17",67.4418604651163
"1104",2017-03-28,"Phoenix Suns",91,"Atlanta Hawks",95,13412,1,4,4,"2016-17",56.8181818181818
"1105",2017-03-28,"Philadelphia 76ers",106,"Brooklyn Nets",101,15471,0,-5,5,"2016-17",31.7073170731707
"1106",2017-03-28,"Miami Heat",97,"Detroit Pistons",96,17160,0,-1,1,"2016-17",58.5365853658537
"1107",2017-03-28,"Golden State Warriors",113,"Houston Rockets",106,18055,0,-7,7,"2016-17",72.3404255319149
"1108",2017-03-28,"Denver Nuggets",113,"Portland Trail Blazers",122,20003,1,9,9,"2016-17",58.1395348837209
"1109",2017-03-28,"Washington Wizards",119,"Los Angeles Lakers",108,18997,0,-11,11,"2016-17",41.4634146341463
"1110",2017-03-29,"Oklahoma City Thunder",114,"Orlando Magic",106,18408,0,-8,8,"2016-17",39.0243902439024
"1111",2017-03-29,"Atlanta Hawks",99,"Philadelphia 76ers",92,15212,0,-7,7,"2016-17",41.4634146341463
"1112",2017-03-29,"Milwaukee Bucks",103,"Boston Celtics",100,18624,0,-3,3,"2016-17",68.6274509803922
"1113",2017-03-29,"Miami Heat",105,"New York Knicks",88,19812,0,-17,17,"2016-17",46.3414634146341
"1114",2017-03-29,"Charlotte Hornets",110,"Toronto Raptors",106,19800,0,-4,4,"2016-17",65.2173913043478
"1115",2017-03-29,"Indiana Pacers",97,"Memphis Grizzlies",110,16367,1,13,13,"2016-17",59.0909090909091
"1116",2017-03-29,"Dallas Mavericks",118,"New Orleans Pelicans",121,16000,1,3,3,"2016-17",51.219512195122
"1117",2017-03-29,"Golden State Warriors",110,"San Antonio Spurs",98,18418,0,-12,12,"2016-17",73.469387755102
"1118",2017-03-29,"Washington Wizards",124,"Los Angeles Clippers",133,19060,1,9,9,"2016-17",66.6666666666667
"1119",2017-03-29,"Utah Jazz",112,"Sacramento Kings",82,17608,0,-30,30,"2016-17",41.4634146341463
"1120",2017-03-30,"Brooklyn Nets",89,"Detroit Pistons",90,15804,1,1,1,"2016-17",58.5365853658537
"1121",2017-03-30,"Cleveland Cavaliers",93,"Chicago Bulls",99,22282,1,6,6,"2016-17",56.8181818181818
"1122",2017-03-30,"Los Angeles Lakers",104,"Minnesota Timberwolves",119,18179,1,15,15,"2016-17",48.780487804878
"1123",2017-03-30,"Los Angeles Clippers",124,"Phoenix Suns",118,16736,0,-6,6,"2016-17",36.5853658536585
"1124",2017-03-30,"Houston Rockets",107,"Portland Trail Blazers",117,20049,1,10,10,"2016-17",58.1395348837209
"1125",2017-03-31,"Denver Nuggets",114,"Charlotte Hornets",122,18353,1,8,8,"2016-17",53.6585365853659
"1126",2017-03-31,"Indiana Pacers",100,"Toronto Raptors",111,19800,1,11,11,"2016-17",65.2173913043478
"1127",2017-03-31,"Orlando Magic",116,"Boston Celtics",117,18624,1,1,1,"2016-17",68.6274509803922
"1128",2017-03-31,"Philadelphia 76ers",105,"Cleveland Cavaliers",122,20562,1,17,17,"2016-17",75.5102040816327
"1129",2017-03-31,"Dallas Mavericks",90,"Memphis Grizzlies",99,17317,1,9,9,"2016-17",59.0909090909091
"1130",2017-03-31,"New York Knicks",98,"Miami Heat",94,19600,0,-4,4,"2016-17",56.0975609756098
"1131",2017-03-31,"Detroit Pistons",105,"Milwaukee Bucks",108,18717,1,3,3,"2016-17",54.5454545454545
"1132",2017-03-31,"Sacramento Kings",89,"New Orleans Pelicans",117,17304,1,28,28,"2016-17",51.219512195122
"1133",2017-03-31,"San Antonio Spurs",100,"Oklahoma City Thunder",95,18203,0,-5,5,"2016-17",67.4418604651163
"1134",2017-03-31,"Washington Wizards",88,"Utah Jazz",95,19911,1,7,7,"2016-17",65.2173913043478
"1135",2017-03-31,"Houston Rockets",98,"Golden State Warriors",107,19596,1,9,9,"2016-17",90
"1136",2017-04-01,"Los Angeles Lakers",104,"Los Angeles Clippers",115,19060,1,11,11,"2016-17",66.6666666666667
"1137",2017-04-01,"Atlanta Hawks",104,"Chicago Bulls",106,22019,1,2,2,"2016-17",56.8181818181818
"1138",2017-04-01,"Orlando Magic",111,"Brooklyn Nets",121,15976,1,10,10,"2016-17",31.7073170731707
"1139",2017-04-01,"Sacramento Kings",123,"Minnesota Timberwolves",117,18960,0,-6,6,"2016-17",48.780487804878
"1140",2017-04-01,"Phoenix Suns",117,"Portland Trail Blazers",130,18915,1,13,13,"2016-17",58.1395348837209
"1141",2017-04-02,"Boston Celtics",110,"New York Knicks",94,19812,0,-16,16,"2016-17",46.3414634146341
"1142",2017-04-02,"Charlotte Hornets",113,"Oklahoma City Thunder",101,18203,0,-12,12,"2016-17",67.4418604651163
"1143",2017-04-02,"Memphis Grizzlies",103,"Los Angeles Lakers",108,18997,1,5,5,"2016-17",41.4634146341463
"1144",2017-04-02,"Dallas Mavericks",109,"Milwaukee Bucks",105,18717,0,-4,4,"2016-17",54.5454545454545
"1145",2017-04-02,"Utah Jazz",103,"San Antonio Spurs",109,18418,1,6,6,"2016-17",73.469387755102
"1146",2017-04-02,"Atlanta Hawks",82,"Brooklyn Nets",91,15040,1,9,9,"2016-17",31.7073170731707
"1147",2017-04-02,"Indiana Pacers",130,"Cleveland Cavaliers",135,20562,1,5,5,"2016-17",75.5102040816327
"1148",2017-04-02,"Denver Nuggets",116,"Miami Heat",113,19600,0,-3,3,"2016-17",56.0975609756098
"1149",2017-04-02,"Chicago Bulls",117,"New Orleans Pelicans",110,18306,0,-7,7,"2016-17",51.219512195122
"1150",2017-04-02,"Philadelphia 76ers",105,"Toronto Raptors",113,19800,1,8,8,"2016-17",65.2173913043478
"1151",2017-04-02,"Washington Wizards",115,"Golden State Warriors",139,19596,1,24,24,"2016-17",90
"1152",2017-04-02,"Houston Rockets",123,"Phoenix Suns",116,17378,0,-7,7,"2016-17",36.5853658536585
"1153",2017-04-03,"Portland Trail Blazers",109,"Minnesota Timberwolves",110,14677,1,1,1,"2016-17",48.780487804878
"1154",2017-04-04,"Orlando Magic",102,"Cleveland Cavaliers",122,20562,1,20,20,"2016-17",75.5102040816327
"1155",2017-04-04,"Toronto Raptors",90,"Indiana Pacers",108,16524,1,18,18,"2016-17",67.4418604651163
"1156",2017-04-04,"Brooklyn Nets",141,"Philadelphia 76ers",118,14580,0,-23,23,"2016-17",41.4634146341463
"1157",2017-04-04,"Charlotte Hornets",111,"Washington Wizards",118,18614,1,7,7,"2016-17",76.5957446808511
"1158",2017-04-04,"Denver Nuggets",134,"New Orleans Pelicans",131,16050,0,-3,3,"2016-17",51.219512195122
"1159",2017-04-04,"Chicago Bulls",91,"New York Knicks",100,19812,1,9,9,"2016-17",46.3414634146341
"1160",2017-04-04,"Milwaukee Bucks",79,"Oklahoma City Thunder",110,18203,1,31,31,"2016-17",67.4418604651163
"1161",2017-04-04,"Memphis Grizzlies",89,"San Antonio Spurs",95,18418,1,6,6,"2016-17",73.469387755102
"1162",2017-04-04,"Portland Trail Blazers",87,"Utah Jazz",106,19911,1,19,19,"2016-17",65.2173913043478
"1163",2017-04-04,"Minnesota Timberwolves",107,"Golden State Warriors",121,19596,1,14,14,"2016-17",90
"1164",2017-04-04,"Dallas Mavericks",87,"Sacramento Kings",98,17608,1,11,11,"2016-17",41.4634146341463
"1165",2017-04-05,"Miami Heat",112,"Charlotte Hornets",99,17758,0,-13,13,"2016-17",53.6585365853659
"1166",2017-04-05,"Toronto Raptors",105,"Detroit Pistons",102,17578,0,-3,3,"2016-17",58.5365853658537
"1167",2017-04-05,"Cleveland Cavaliers",114,"Boston Celtics",91,18624,0,-23,23,"2016-17",68.6274509803922
"1168",2017-04-05,"Denver Nuggets",104,"Houston Rockets",110,18055,1,6,6,"2016-17",72.3404255319149
"1169",2017-04-05,"Oklahoma City Thunder",103,"Memphis Grizzlies",100,17298,0,-3,3,"2016-17",59.0909090909091
"1170",2017-04-05,"Los Angeles Lakers",102,"San Antonio Spurs",95,18418,0,-7,7,"2016-17",73.469387755102
"1171",2017-04-05,"Golden State Warriors",120,"Phoenix Suns",111,18055,0,-9,9,"2016-17",36.5853658536585
"1172",2017-04-05,"Dallas Mavericks",101,"Los Angeles Clippers",112,19060,1,11,11,"2016-17",66.6666666666667
"1173",2017-04-06,"Milwaukee Bucks",89,"Indiana Pacers",104,17010,1,15,15,"2016-17",67.4418604651163
"1174",2017-04-06,"Brooklyn Nets",107,"Orlando Magic",115,18095,1,8,8,"2016-17",39.0243902439024
"1175",2017-04-06,"Chicago Bulls",102,"Philadelphia 76ers",90,15177,0,-12,12,"2016-17",41.4634146341463
"1176",2017-04-06,"Washington Wizards",106,"New York Knicks",103,19812,0,-3,3,"2016-17",46.3414634146341
"1177",2017-04-06,"Boston Celtics",116,"Atlanta Hawks",123,18688,1,7,7,"2016-17",56.8181818181818
"1178",2017-04-06,"Minnesota Timberwolves",98,"Portland Trail Blazers",105,19393,1,7,7,"2016-17",58.1395348837209
"1179",2017-04-07,"Atlanta Hawks",114,"Cleveland Cavaliers",100,20562,0,-14,14,"2016-17",75.5102040816327
"1180",2017-04-07,"Miami Heat",94,"Toronto Raptors",96,19800,1,2,2,"2016-17",65.2173913043478
"1181",2017-04-07,"Detroit Pistons",114,"Houston Rockets",109,18055,0,-5,5,"2016-17",72.3404255319149
"1182",2017-04-07,"New York Knicks",88,"Memphis Grizzlies",101,17631,1,13,13,"2016-17",59.0909090909091
"1183",2017-04-07,"San Antonio Spurs",102,"Dallas Mavericks",89,20133,0,-13,13,"2016-17",51.219512195122
"1184",2017-04-07,"New Orleans Pelicans",106,"Denver Nuggets",122,16348,1,16,16,"2016-17",53.6585365853659
"1185",2017-04-07,"Minnesota Timberwolves",113,"Utah Jazz",120,19911,1,7,7,"2016-17",65.2173913043478
"1186",2017-04-07,"Oklahoma City Thunder",99,"Phoenix Suns",120,18055,1,21,21,"2016-17",36.5853658536585
"1187",2017-04-07,"Sacramento Kings",94,"Los Angeles Lakers",98,18997,1,4,4,"2016-17",41.4634146341463
"1188",2017-04-08,"Chicago Bulls",106,"Brooklyn Nets",107,17732,1,1,1,"2016-17",31.7073170731707
"1189",2017-04-08,"Boston Celtics",121,"Charlotte Hornets",114,19407,0,-7,7,"2016-17",53.6585365853659
"1190",2017-04-08,"Indiana Pacers",127,"Orlando Magic",112,18846,0,-15,15,"2016-17",39.0243902439024
"1191",2017-04-08,"Milwaukee Bucks",90,"Philadelphia 76ers",82,16301,0,-8,8,"2016-17",41.4634146341463
"1192",2017-04-08,"Miami Heat",106,"Washington Wizards",103,20365,0,-3,3,"2016-17",76.5957446808511
"1193",2017-04-08,"Los Angeles Clippers",98,"San Antonio Spurs",87,18420,0,-11,11,"2016-17",73.469387755102
"1194",2017-04-08,"Utah Jazz",86,"Portland Trail Blazers",101,19865,1,15,15,"2016-17",58.1395348837209
"1195",2017-04-08,"New Orleans Pelicans",101,"Golden State Warriors",123,19596,1,22,22,"2016-17",90
"1196",2017-04-09,"Toronto Raptors",110,"New York Knicks",97,19812,0,-13,13,"2016-17",46.3414634146341
"1197",2017-04-09,"Cleveland Cavaliers",125,"Atlanta Hawks",126,18835,1,1,1,"2016-17",56.8181818181818
"1198",2017-04-09,"Oklahoma City Thunder",106,"Denver Nuggets",105,19718,0,-1,1,"2016-17",53.6585365853659
"1199",2017-04-09,"Detroit Pistons",103,"Memphis Grizzlies",90,16521,0,-13,13,"2016-17",59.0909090909091
"1200",2017-04-09,"Dallas Mavericks",111,"Phoenix Suns",124,18055,1,13,13,"2016-17",36.5853658536585
"1201",2017-04-09,"Houston Rockets",135,"Sacramento Kings",128,17608,0,-7,7,"2016-17",41.4634146341463
"1202",2017-04-09,"Minnesota Timberwolves",109,"Los Angeles Lakers",110,18997,1,1,1,"2016-17",41.4634146341463
"1203",2017-04-10,"Indiana Pacers",120,"Philadelphia 76ers",111,14622,0,-9,9,"2016-17",41.4634146341463
"1204",2017-04-10,"Brooklyn Nets",105,"Boston Celtics",114,18624,1,9,9,"2016-17",68.6274509803922
"1205",2017-04-10,"Cleveland Cavaliers",121,"Miami Heat",124,19673,1,3,3,"2016-17",56.0975609756098
"1206",2017-04-10,"Orlando Magic",75,"Chicago Bulls",122,21545,1,47,47,"2016-17",56.8181818181818
"1207",2017-04-10,"Washington Wizards",105,"Detroit Pistons",101,21012,0,-4,4,"2016-17",58.5365853658537
"1208",2017-04-10,"Charlotte Hornets",79,"Milwaukee Bucks",89,18717,1,10,10,"2016-17",54.5454545454545
"1209",2017-04-10,"San Antonio Spurs",98,"Portland Trail Blazers",99,19393,1,1,1,"2016-17",58.1395348837209
"1210",2017-04-10,"Utah Jazz",105,"Golden State Warriors",99,19596,0,-6,6,"2016-17",90
"1211",2017-04-10,"Houston Rockets",96,"Los Angeles Clippers",125,19163,1,29,29,"2016-17",66.6666666666667
"1212",2017-04-11,"Charlotte Hornets",76,"Atlanta Hawks",103,14205,1,27,27,"2016-17",56.8181818181818
"1213",2017-04-11,"Oklahoma City Thunder",100,"Minnesota Timberwolves",98,19356,0,-2,2,"2016-17",48.780487804878
"1214",2017-04-11,"Denver Nuggets",109,"Dallas Mavericks",91,20333,0,-18,18,"2016-17",51.219512195122
"1215",2017-04-11,"New Orleans Pelicans",96,"Los Angeles Lakers",108,18997,1,12,12,"2016-17",41.4634146341463
"1216",2017-04-11,"Phoenix Suns",104,"Sacramento Kings",129,17608,1,25,25,"2016-17",41.4634146341463
"1217",2017-04-12,"Milwaukee Bucks",94,"Boston Celtics",112,18624,1,18,18,"2016-17",68.6274509803922
"1218",2017-04-12,"Brooklyn Nets",73,"Chicago Bulls",112,21648,1,39,39,"2016-17",56.8181818181818
"1219",2017-04-12,"Toronto Raptors",98,"Cleveland Cavaliers",83,20562,0,-15,15,"2016-17",75.5102040816327
"1220",2017-04-12,"Minnesota Timberwolves",118,"Houston Rockets",123,18055,1,5,5,"2016-17",72.3404255319149
"1221",2017-04-12,"Atlanta Hawks",86,"Indiana Pacers",104,17923,1,18,18,"2016-17",67.4418604651163
"1222",2017-04-12,"Dallas Mavericks",100,"Memphis Grizzlies",93,16274,0,-7,7,"2016-17",59.0909090909091
"1223",2017-04-12,"Washington Wizards",102,"Miami Heat",110,19963,1,8,8,"2016-17",56.0975609756098
"1224",2017-04-12,"Philadelphia 76ers",113,"New York Knicks",114,19812,1,1,1,"2016-17",46.3414634146341
"1225",2017-04-12,"Denver Nuggets",111,"Oklahoma City Thunder",105,18203,0,-6,6,"2016-17",67.4418604651163
"1226",2017-04-12,"Detroit Pistons",109,"Orlando Magic",113,19458,1,4,4,"2016-17",39.0243902439024
"1227",2017-04-12,"San Antonio Spurs",97,"Utah Jazz",101,19911,1,4,4,"2016-17",65.2173913043478
"1228",2017-04-12,"Los Angeles Lakers",94,"Golden State Warriors",109,19596,1,15,15,"2016-17",90
"1229",2017-04-12,"Sacramento Kings",95,"Los Angeles Clippers",115,19060,1,20,20,"2016-17",66.6666666666667
"1230",2017-04-12,"New Orleans Pelicans",103,"Portland Trail Blazers",100,19521,0,-3,3,"2016-17",58.1395348837209
"1231",2017-04-15,"Indiana Pacers",108,"Cleveland Cavaliers",109,20562,1,1,1,"2016-17",75.5102040816327
"1232",2017-04-15,"Milwaukee Bucks",97,"Toronto Raptors",83,20133,0,-14,14,"2016-17",65.2173913043478
"1233",2017-04-15,"Memphis Grizzlies",82,"San Antonio Spurs",111,18418,1,29,29,"2016-17",73.469387755102
"1234",2017-04-15,"Utah Jazz",97,"Los Angeles Clippers",95,19060,0,-2,2,"2016-17",66.6666666666667
"1235",2017-04-16,"Atlanta Hawks",107,"Washington Wizards",114,20356,1,7,7,"2016-17",76.5957446808511
"1236",2017-04-16,"Portland Trail Blazers",109,"Golden State Warriors",121,19596,1,12,12,"2016-17",90
"1237",2017-04-16,"Chicago Bulls",106,"Boston Celtics",102,18624,0,-4,4,"2016-17",68.6274509803922
"1238",2017-04-16,"Oklahoma City Thunder",87,"Houston Rockets",118,18055,1,31,31,"2016-17",72.3404255319149
"1239",2017-04-17,"Indiana Pacers",111,"Cleveland Cavaliers",117,20562,1,6,6,"2016-17",75.5102040816327
"1240",2017-04-17,"Memphis Grizzlies",82,"San Antonio Spurs",96,18418,1,14,14,"2016-17",73.469387755102
"1241",2017-04-18,"Milwaukee Bucks",100,"Toronto Raptors",106,20077,1,6,6,"2016-17",65.2173913043478
"1242",2017-04-18,"Chicago Bulls",111,"Boston Celtics",97,18624,0,-14,14,"2016-17",68.6274509803922
"1243",2017-04-18,"Utah Jazz",91,"Los Angeles Clippers",99,19060,1,8,8,"2016-17",66.6666666666667
"1244",2017-04-19,"Atlanta Hawks",101,"Washington Wizards",109,20356,1,8,8,"2016-17",76.5957446808511
"1245",2017-04-19,"Oklahoma City Thunder",111,"Houston Rockets",115,18055,1,4,4,"2016-17",72.3404255319149
"1246",2017-04-19,"Portland Trail Blazers",81,"Golden State Warriors",110,19596,1,29,29,"2016-17",90
"1247",2017-04-20,"Cleveland Cavaliers",119,"Indiana Pacers",114,17923,0,-5,5,"2016-17",67.4418604651163
"1248",2017-04-20,"Toronto Raptors",77,"Milwaukee Bucks",104,18717,1,27,27,"2016-17",54.5454545454545
"1249",2017-04-20,"San Antonio Spurs",94,"Memphis Grizzlies",105,18119,1,11,11,"2016-17",59.0909090909091
"1250",2017-04-21,"Boston Celtics",104,"Chicago Bulls",87,21293,0,-17,17,"2016-17",56.8181818181818
"1251",2017-04-21,"Houston Rockets",113,"Oklahoma City Thunder",115,18203,1,2,2,"2016-17",67.4418604651163
"1252",2017-04-21,"Los Angeles Clippers",111,"Utah Jazz",106,19911,0,-5,5,"2016-17",65.2173913043478
"1253",2017-04-22,"Toronto Raptors",87,"Milwaukee Bucks",76,18717,0,-11,11,"2016-17",54.5454545454545
"1254",2017-04-22,"Washington Wizards",98,"Atlanta Hawks",116,18866,1,18,18,"2016-17",56.8181818181818
"1255",2017-04-22,"San Antonio Spurs",108,"Memphis Grizzlies",110,18119,1,2,2,"2016-17",59.0909090909091
"1256",2017-04-22,"Golden State Warriors",119,"Portland Trail Blazers",113,20177,0,-6,6,"2016-17",58.1395348837209
"1257",2017-04-23,"Cleveland Cavaliers",106,"Indiana Pacers",102,17923,0,-4,4,"2016-17",67.4418604651163
"1258",2017-04-23,"Houston Rockets",113,"Oklahoma City Thunder",109,18203,0,-4,4,"2016-17",67.4418604651163
"1259",2017-04-23,"Boston Celtics",104,"Chicago Bulls",95,21863,0,-9,9,"2016-17",56.8181818181818
"1260",2017-04-23,"Los Angeles Clippers",98,"Utah Jazz",105,19911,1,7,7,"2016-17",65.2173913043478
"1261",2017-04-24,"Milwaukee Bucks",93,"Toronto Raptors",118,20251,1,25,25,"2016-17",65.2173913043478
"1262",2017-04-24,"Washington Wizards",101,"Atlanta Hawks",111,18676,1,10,10,"2016-17",56.8181818181818
"1263",2017-04-24,"Golden State Warriors",128,"Portland Trail Blazers",103,19902,0,-25,25,"2016-17",58.1395348837209
"1264",2017-04-25,"Oklahoma City Thunder",99,"Houston Rockets",105,18055,1,6,6,"2016-17",72.3404255319149
"1265",2017-04-25,"Memphis Grizzlies",103,"San Antonio Spurs",116,18418,1,13,13,"2016-17",73.469387755102
"1266",2017-04-25,"Utah Jazz",96,"Los Angeles Clippers",92,19171,0,-4,4,"2016-17",66.6666666666667
"1267",2017-04-26,"Atlanta Hawks",99,"Washington Wizards",103,20356,1,4,4,"2016-17",76.5957446808511
"1268",2017-04-26,"Chicago Bulls",97,"Boston Celtics",108,18624,1,11,11,"2016-17",68.6274509803922
"1269",2017-04-27,"Toronto Raptors",92,"Milwaukee Bucks",89,18717,0,-3,3,"2016-17",54.5454545454545
"1270",2017-04-27,"San Antonio Spurs",103,"Memphis Grizzlies",96,18119,0,-7,7,"2016-17",59.0909090909091
"1271",2017-04-28,"Washington Wizards",115,"Atlanta Hawks",99,18849,0,-16,16,"2016-17",56.8181818181818
"1272",2017-04-28,"Boston Celtics",105,"Chicago Bulls",83,21682,0,-22,22,"2016-17",56.8181818181818
"1273",2017-04-28,"Los Angeles Clippers",98,"Utah Jazz",93,19911,0,-5,5,"2016-17",65.2173913043478
"1274",2017-04-30,"Washington Wizards",111,"Boston Celtics",123,18624,1,12,12,"2016-17",68.6274509803922
"1275",2017-04-30,"Utah Jazz",104,"Los Angeles Clippers",91,19060,0,-13,13,"2016-17",66.6666666666667
"1276",2017-05-01,"Toronto Raptors",105,"Cleveland Cavaliers",116,20562,1,11,11,"2016-17",75.5102040816327
"1277",2017-05-01,"Houston Rockets",126,"San Antonio Spurs",99,18418,0,-27,27,"2016-17",73.469387755102
"1278",2017-05-02,"Washington Wizards",119,"Boston Celtics",129,18624,1,10,10,"2016-17",68.6274509803922
"1279",2017-05-02,"Utah Jazz",94,"Golden State Warriors",106,19596,1,12,12,"2016-17",90
"1280",2017-05-03,"Toronto Raptors",103,"Cleveland Cavaliers",125,20562,1,22,22,"2016-17",75.5102040816327
"1281",2017-05-03,"Houston Rockets",96,"San Antonio Spurs",121,18418,1,25,25,"2016-17",73.469387755102
"1282",2017-05-04,"Boston Celtics",89,"Washington Wizards",116,20356,1,27,27,"2016-17",76.5957446808511
"1283",2017-05-04,"Utah Jazz",104,"Golden State Warriors",115,19596,1,11,11,"2016-17",90
"1284",2017-05-05,"Cleveland Cavaliers",115,"Toronto Raptors",94,20384,0,-21,21,"2016-17",65.2173913043478
"1285",2017-05-05,"San Antonio Spurs",103,"Houston Rockets",92,18187,0,-11,11,"2016-17",72.3404255319149
"1286",2017-05-06,"Golden State Warriors",102,"Utah Jazz",91,19911,0,-11,11,"2016-17",65.2173913043478
"1287",2017-05-07,"Cleveland Cavaliers",109,"Toronto Raptors",102,20307,0,-7,7,"2016-17",65.2173913043478
"1288",2017-05-07,"Boston Celtics",102,"Washington Wizards",121,20356,1,19,19,"2016-17",76.5957446808511
"1289",2017-05-07,"San Antonio Spurs",104,"Houston Rockets",125,18055,1,21,21,"2016-17",72.3404255319149
"1290",2017-05-08,"Golden State Warriors",121,"Utah Jazz",95,19911,0,-26,26,"2016-17",65.2173913043478
"1291",2017-05-09,"Houston Rockets",107,"San Antonio Spurs",110,18418,1,3,3,"2016-17",73.469387755102
"1292",2017-05-10,"Washington Wizards",101,"Boston Celtics",123,18624,1,22,22,"2016-17",68.6274509803922
"1293",2017-05-11,"San Antonio Spurs",114,"Houston Rockets",75,18055,0,-39,39,"2016-17",72.3404255319149
"1294",2017-05-12,"Boston Celtics",91,"Washington Wizards",92,20356,1,1,1,"2016-17",76.5957446808511
"1295",2017-05-14,"San Antonio Spurs",111,"Golden State Warriors",113,19596,1,2,2,"2016-17",90
"1296",2017-05-15,"Washington Wizards",105,"Boston Celtics",115,18624,1,10,10,"2016-17",68.6274509803922
"1297",2017-05-16,"San Antonio Spurs",100,"Golden State Warriors",136,19596,1,36,36,"2016-17",90
"1298",2017-05-17,"Cleveland Cavaliers",117,"Boston Celtics",104,18624,0,-13,13,"2016-17",68.6274509803922
"1299",2017-05-19,"Cleveland Cavaliers",130,"Boston Celtics",86,18624,0,-44,44,"2016-17",68.6274509803922
"1300",2017-05-20,"Golden State Warriors",120,"San Antonio Spurs",108,18792,0,-12,12,"2016-17",73.469387755102
"1301",2017-05-21,"Boston Celtics",111,"Cleveland Cavaliers",108,20562,0,-3,3,"2016-17",75.5102040816327
"1302",2017-05-22,"Golden State Warriors",129,"San Antonio Spurs",115,18466,0,-14,14,"2016-17",73.469387755102
"1303",2017-05-23,"Boston Celtics",99,"Cleveland Cavaliers",112,20562,1,13,13,"2016-17",75.5102040816327
"1304",2017-05-25,"Cleveland Cavaliers",135,"Boston Celtics",102,18624,0,-33,33,"2016-17",68.6274509803922
"1305",2017-06-01,"Cleveland Cavaliers",91,"Golden State Warriors",113,19596,1,22,22,"2016-17",90
"1306",2017-06-04,"Cleveland Cavaliers",113,"Golden State Warriors",132,19596,1,19,19,"2016-17",90
"1307",2017-06-07,"Golden State Warriors",118,"Cleveland Cavaliers",113,20562,0,-5,5,"2016-17",75.5102040816327
"1308",2017-06-09,"Golden State Warriors",116,"Cleveland Cavaliers",137,20562,1,21,21,"2016-17",75.5102040816327
"1309",2017-06-12,"Cleveland Cavaliers",120,"Golden State Warriors",129,19596,1,9,9,"2016-17",90
"1310",2017-10-17,"Boston Celtics",99,"Cleveland Cavaliers",102,20562,1,3,3,"2017-18",71.1538461538462
"1311",2017-10-17,"Houston Rockets",122,"Golden State Warriors",121,19596,0,-1,1,"2017-18",75
"1312",2017-10-18,"Charlotte Hornets",90,"Detroit Pistons",102,20491,1,12,12,"2017-18",60.9756097560976
"1313",2017-10-18,"Brooklyn Nets",131,"Indiana Pacers",140,15008,1,9,9,"2017-18",65.9090909090909
"1314",2017-10-18,"Miami Heat",109,"Orlando Magic",116,18846,1,7,7,"2017-18",41.4634146341463
"1315",2017-10-18,"Philadelphia 76ers",115,"Washington Wizards",120,20356,1,5,5,"2017-18",56.8181818181818
"1316",2017-10-18,"Milwaukee Bucks",108,"Boston Celtics",100,18624,0,-8,8,"2017-18",71.1538461538462
"1317",2017-10-18,"New Orleans Pelicans",91,"Memphis Grizzlies",103,17794,1,12,12,"2017-18",39.0243902439024
"1318",2017-10-18,"Atlanta Hawks",117,"Dallas Mavericks",111,19709,0,-6,6,"2017-18",36.5853658536585
"1319",2017-10-18,"Denver Nuggets",96,"Utah Jazz",106,17588,1,10,10,"2017-18",67.3913043478261
"1320",2017-10-18,"Minnesota Timberwolves",99,"San Antonio Spurs",107,18418,1,8,8,"2017-18",79.0697674418605
"1321",2017-10-18,"Portland Trail Blazers",124,"Phoenix Suns",76,18055,0,-48,48,"2017-18",24.390243902439
"1322",2017-10-18,"Houston Rockets",105,"Sacramento Kings",100,17583,0,-5,5,"2017-18",34.1463414634146
"1323",2017-10-19,"Chicago Bulls",100,"Toronto Raptors",117,19800,1,17,17,"2017-18",80.4347826086957
"1324",2017-10-19,"New York Knicks",84,"Oklahoma City Thunder",105,18203,1,21,21,"2017-18",65.9090909090909
"1325",2017-10-19,"Los Angeles Clippers",108,"Los Angeles Lakers",92,18997,0,-16,16,"2017-18",48.780487804878
"1326",2017-10-20,"Atlanta Hawks",91,"Charlotte Hornets",109,18417,1,18,18,"2017-18",51.219512195122
"1327",2017-10-20,"Portland Trail Blazers",114,"Indiana Pacers",96,15325,0,-18,18,"2017-18",65.9090909090909
"1328",2017-10-20,"Cleveland Cavaliers",116,"Milwaukee Bucks",97,18717,0,-19,19,"2017-18",63.6363636363636
"1329",2017-10-20,"Boston Celtics",102,"Philadelphia 76ers",92,20816,0,-10,10,"2017-18",71.7391304347826
"1330",2017-10-20,"Detroit Pistons",111,"Washington Wizards",115,16337,1,4,4,"2017-18",56.8181818181818
"1331",2017-10-20,"Orlando Magic",121,"Brooklyn Nets",126,16144,1,5,5,"2017-18",36.5853658536585
"1332",2017-10-20,"Utah Jazz",97,"Minnesota Timberwolves",100,18978,1,3,3,"2017-18",72.0930232558139
"1333",2017-10-20,"Sacramento Kings",93,"Dallas Mavericks",88,19273,0,-5,5,"2017-18",36.5853658536585
"1334",2017-10-20,"Golden State Warriors",128,"New Orleans Pelicans",120,18171,0,-8,8,"2017-18",60
"1335",2017-10-20,"Los Angeles Lakers",132,"Phoenix Suns",130,18055,0,-2,2,"2017-18",24.390243902439
"1336",2017-10-21,"Philadelphia 76ers",94,"Toronto Raptors",128,19800,1,34,34,"2017-18",80.4347826086957
"1337",2017-10-21,"San Antonio Spurs",87,"Chicago Bulls",77,21640,0,-10,10,"2017-18",41.4634146341463
"1338",2017-10-21,"Orlando Magic",114,"Cleveland Cavaliers",93,20562,0,-21,21,"2017-18",71.1538461538462
"1339",2017-10-21,"Dallas Mavericks",91,"Houston Rockets",107,18055,1,16,16,"2017-18",80.3921568627451
"1340",2017-10-21,"Golden State Warriors",101,"Memphis Grizzlies",111,17794,1,10,10,"2017-18",39.0243902439024
"1341",2017-10-21,"Indiana Pacers",108,"Miami Heat",112,19600,1,4,4,"2017-18",60.4651162790698
"1342",2017-10-21,"Detroit Pistons",111,"New York Knicks",107,19812,0,-4,4,"2017-18",46.3414634146341
"1343",2017-10-21,"Portland Trail Blazers",110,"Milwaukee Bucks",113,16211,1,3,3,"2017-18",63.6363636363636
"1344",2017-10-21,"Sacramento Kings",79,"Denver Nuggets",96,19520,1,17,17,"2017-18",75.609756097561
"1345",2017-10-21,"Oklahoma City Thunder",87,"Utah Jazz",96,18300,1,9,9,"2017-18",67.3913043478261
"1346",2017-10-21,"Phoenix Suns",88,"Los Angeles Clippers",130,19068,1,42,42,"2017-18",53.6585365853659
"1347",2017-10-22,"Atlanta Hawks",104,"Brooklyn Nets",116,13917,1,12,12,"2017-18",36.5853658536585
"1348",2017-10-22,"Minnesota Timberwolves",115,"Oklahoma City Thunder",113,18203,0,-2,2,"2017-18",65.9090909090909
"1349",2017-10-22,"New Orleans Pelicans",119,"Los Angeles Lakers",112,18997,0,-7,7,"2017-18",48.780487804878
"1350",2017-10-23,"Philadelphia 76ers",97,"Detroit Pistons",86,13709,0,-11,11,"2017-18",60.9756097560976
"1351",2017-10-23,"Atlanta Hawks",93,"Miami Heat",104,19600,1,11,11,"2017-18",60.4651162790698
"1352",2017-10-23,"Memphis Grizzlies",98,"Houston Rockets",90,17129,0,-8,8,"2017-18",80.3921568627451
"1353",2017-10-23,"Charlotte Hornets",94,"Milwaukee Bucks",103,12887,1,9,9,"2017-18",63.6363636363636
"1354",2017-10-23,"Golden State Warriors",133,"Dallas Mavericks",103,19875,0,-30,30,"2017-18",36.5853658536585
"1355",2017-10-23,"Toronto Raptors",97,"San Antonio Spurs",101,18418,1,4,4,"2017-18",79.0697674418605
"1356",2017-10-23,"Washington Wizards",109,"Denver Nuggets",104,14294,0,-5,5,"2017-18",75.609756097561
"1357",2017-10-23,"Sacramento Kings",115,"Phoenix Suns",117,14903,1,2,2,"2017-18",24.390243902439
"1358",2017-10-24,"Chicago Bulls",112,"Cleveland Cavaliers",119,20562,1,7,7,"2017-18",71.1538461538462
"1359",2017-10-24,"Brooklyn Nets",121,"Orlando Magic",125,16015,1,4,4,"2017-18",41.4634146341463
"1360",2017-10-24,"New York Knicks",89,"Boston Celtics",110,18624,1,21,21,"2017-18",71.1538461538462
"1361",2017-10-24,"Indiana Pacers",130,"Minnesota Timberwolves",107,14353,0,-23,23,"2017-18",72.0930232558139
"1362",2017-10-24,"New Orleans Pelicans",93,"Portland Trail Blazers",103,19446,1,10,10,"2017-18",65.1162790697674
"1363",2017-10-24,"Utah Jazz",84,"Los Angeles Clippers",102,16607,1,18,18,"2017-18",53.6585365853659
"1364",2017-10-25,"Denver Nuggets",93,"Charlotte Hornets",110,14253,1,17,17,"2017-18",51.219512195122
"1365",2017-10-25,"Minnesota Timberwolves",101,"Detroit Pistons",122,13790,1,21,21,"2017-18",60.9756097560976
"1366",2017-10-25,"Houston Rockets",105,"Philadelphia 76ers",104,20682,0,-1,1,"2017-18",71.7391304347826
"1367",2017-10-25,"Cleveland Cavaliers",107,"Brooklyn Nets",112,17732,1,5,5,"2017-18",36.5853658536585
"1368",2017-10-25,"San Antonio Spurs",117,"Miami Heat",100,19600,0,-17,17,"2017-18",60.4651162790698
"1369",2017-10-25,"Indiana Pacers",96,"Oklahoma City Thunder",114,18203,1,18,18,"2017-18",65.9090909090909
"1370",2017-10-25,"Memphis Grizzlies",94,"Dallas Mavericks",103,19674,1,9,9,"2017-18",36.5853658536585
"1371",2017-10-25,"Utah Jazz",88,"Phoenix Suns",97,16022,1,9,9,"2017-18",24.390243902439
"1372",2017-10-25,"Toronto Raptors",112,"Golden State Warriors",117,19596,1,5,5,"2017-18",75
"1373",2017-10-25,"Washington Wizards",99,"Los Angeles Lakers",102,18996,1,3,3,"2017-18",48.780487804878
"1374",2017-10-26,"Atlanta Hawks",86,"Chicago Bulls",91,21104,1,5,5,"2017-18",41.4634146341463
"1375",2017-10-26,"Dallas Mavericks",91,"Memphis Grizzlies",96,15839,1,5,5,"2017-18",39.0243902439024
"1376",2017-10-26,"Boston Celtics",96,"Milwaukee Bucks",89,11046,0,-7,7,"2017-18",63.6363636363636
"1377",2017-10-26,"Los Angeles Clippers",104,"Portland Trail Blazers",103,18694,0,-1,1,"2017-18",65.1162790697674
"1378",2017-10-26,"New Orleans Pelicans",114,"Sacramento Kings",106,17583,0,-8,8,"2017-18",34.1463414634146
"1379",2017-10-27,"Houston Rockets",109,"Charlotte Hornets",93,17339,0,-16,16,"2017-18",51.219512195122
"1380",2017-10-27,"San Antonio Spurs",87,"Orlando Magic",114,17337,1,27,27,"2017-18",41.4634146341463
"1381",2017-10-27,"Denver Nuggets",105,"Atlanta Hawks",100,16220,0,-5,5,"2017-18",39.0243902439024
"1382",2017-10-27,"Brooklyn Nets",86,"New York Knicks",107,19812,1,21,21,"2017-18",46.3414634146341
"1383",2017-10-27,"Oklahoma City Thunder",116,"Minnesota Timberwolves",119,17620,1,3,3,"2017-18",72.0930232558139
"1384",2017-10-27,"Washington Wizards",117,"Golden State Warriors",120,19596,1,3,3,"2017-18",75
"1385",2017-10-27,"Toronto Raptors",101,"Los Angeles Lakers",92,17876,0,-9,9,"2017-18",48.780487804878
"1386",2017-10-28,"Cleveland Cavaliers",101,"New Orleans Pelicans",123,18539,1,22,22,"2017-18",60
"1387",2017-10-28,"Oklahoma City Thunder",101,"Chicago Bulls",69,21706,0,-32,32,"2017-18",41.4634146341463
"1388",2017-10-28,"Houston Rockets",89,"Memphis Grizzlies",103,17033,1,14,14,"2017-18",39.0243902439024
"1389",2017-10-28,"Boston Celtics",96,"Miami Heat",90,19600,0,-6,6,"2017-18",60.4651162790698
"1390",2017-10-28,"Philadelphia 76ers",112,"Dallas Mavericks",110,19567,0,-2,2,"2017-18",36.5853658536585
"1391",2017-10-28,"Los Angeles Lakers",81,"Utah Jazz",96,18306,1,15,15,"2017-18",67.3913043478261
"1392",2017-10-28,"Phoenix Suns",107,"Portland Trail Blazers",114,19343,1,7,7,"2017-18",65.1162790697674
"1393",2017-10-28,"Detroit Pistons",95,"Los Angeles Clippers",87,17247,0,-8,8,"2017-18",53.6585365853659
"1394",2017-10-29,"Milwaukee Bucks",117,"Atlanta Hawks",106,14014,0,-11,11,"2017-18",39.0243902439024
"1395",2017-10-29,"San Antonio Spurs",94,"Indiana Pacers",97,15013,1,3,3,"2017-18",65.9090909090909
"1396",2017-10-29,"Denver Nuggets",124,"Brooklyn Nets",111,14854,0,-13,13,"2017-18",36.5853658536585
"1397",2017-10-29,"Orlando Magic",113,"Charlotte Hornets",120,15531,1,7,7,"2017-18",51.219512195122
"1398",2017-10-29,"Washington Wizards",110,"Sacramento Kings",83,17583,0,-27,27,"2017-18",34.1463414634146
"1399",2017-10-29,"New York Knicks",114,"Cleveland Cavaliers",95,20562,0,-19,19,"2017-18",71.1538461538462
"1400",2017-10-29,"Detroit Pistons",115,"Golden State Warriors",107,19596,0,-8,8,"2017-18",75
"1401",2017-10-30,"San Antonio Spurs",94,"Boston Celtics",108,18624,1,14,14,"2017-18",71.1538461538462
"1402",2017-10-30,"Minnesota Timberwolves",125,"Miami Heat",122,19600,0,-3,3,"2017-18",60.4651162790698
"1403",2017-10-30,"Denver Nuggets",110,"New York Knicks",116,19812,1,6,6,"2017-18",46.3414634146341
"1404",2017-10-30,"Philadelphia 76ers",115,"Houston Rockets",107,16714,0,-8,8,"2017-18",80.3921568627451
"1405",2017-10-30,"Charlotte Hornets",104,"Memphis Grizzlies",99,15771,0,-5,5,"2017-18",39.0243902439024
"1406",2017-10-30,"Orlando Magic",115,"New Orleans Pelicans",99,14004,0,-16,16,"2017-18",60
"1407",2017-10-30,"Dallas Mavericks",89,"Utah Jazz",104,16221,1,15,15,"2017-18",67.3913043478261
"1408",2017-10-30,"Toronto Raptors",99,"Portland Trail Blazers",85,18505,0,-14,14,"2017-18",65.1162790697674
"1409",2017-10-30,"Golden State Warriors",141,"Los Angeles Clippers",113,19068,0,-28,28,"2017-18",53.6585365853659
"1410",2017-10-31,"Sacramento Kings",83,"Indiana Pacers",101,12245,1,18,18,"2017-18",65.9090909090909
"1411",2017-10-31,"Phoenix Suns",122,"Brooklyn Nets",114,12936,0,-8,8,"2017-18",36.5853658536585
"1412",2017-10-31,"Oklahoma City Thunder",110,"Milwaukee Bucks",91,16713,0,-19,19,"2017-18",63.6363636363636
"1413",2017-10-31,"Detroit Pistons",93,"Los Angeles Lakers",113,17569,1,20,20,"2017-18",48.780487804878
"1414",2017-11-01,"Milwaukee Bucks",121,"Charlotte Hornets",126,15655,1,5,5,"2017-18",51.219512195122
"1415",2017-11-01,"Indiana Pacers",124,"Cleveland Cavaliers",107,20562,0,-17,17,"2017-18",71.1538461538462
"1416",2017-11-01,"Atlanta Hawks",109,"Philadelphia 76ers",119,20549,1,10,10,"2017-18",71.7391304347826
"1417",2017-11-01,"Phoenix Suns",122,"Washington Wizards",116,14790,0,-6,6,"2017-18",56.8181818181818
"1418",2017-11-01,"Sacramento Kings",86,"Boston Celtics",113,18624,1,27,27,"2017-18",71.1538461538462
"1419",2017-11-01,"Chicago Bulls",91,"Miami Heat",97,19600,1,6,6,"2017-18",60.4651162790698
"1420",2017-11-01,"Orlando Magic",101,"Memphis Grizzlies",99,15434,0,-2,2,"2017-18",39.0243902439024
"1421",2017-11-01,"Minnesota Timberwolves",104,"New Orleans Pelicans",98,14788,0,-6,6,"2017-18",60
"1422",2017-11-01,"Houston Rockets",119,"New York Knicks",97,18320,0,-22,22,"2017-18",46.3414634146341
"1423",2017-11-01,"Toronto Raptors",111,"Denver Nuggets",129,14072,1,18,18,"2017-18",75.609756097561
"1424",2017-11-01,"Portland Trail Blazers",103,"Utah Jazz",112,16685,1,9,9,"2017-18",67.3913043478261
"1425",2017-11-01,"Dallas Mavericks",98,"Los Angeles Clippers",119,13487,1,21,21,"2017-18",53.6585365853659
"1426",2017-11-02,"Golden State Warriors",112,"San Antonio Spurs",92,18418,0,-20,20,"2017-18",79.0697674418605
"1427",2017-11-02,"Los Angeles Lakers",110,"Portland Trail Blazers",113,19469,1,3,3,"2017-18",65.1162790697674
"1428",2017-11-03,"Milwaukee Bucks",96,"Detroit Pistons",105,17207,1,9,9,"2017-18",60.9756097560976
"1429",2017-11-03,"Chicago Bulls",105,"Orlando Magic",83,19171,0,-22,22,"2017-18",41.4634146341463
"1430",2017-11-03,"Indiana Pacers",110,"Philadelphia 76ers",121,20668,1,11,11,"2017-18",71.7391304347826
"1431",2017-11-03,"Cleveland Cavaliers",130,"Washington Wizards",122,20356,0,-8,8,"2017-18",56.8181818181818
"1432",2017-11-03,"Houston Rockets",119,"Atlanta Hawks",104,14087,0,-15,15,"2017-18",39.0243902439024
"1433",2017-11-03,"Phoenix Suns",107,"New York Knicks",120,19404,1,13,13,"2017-18",46.3414634146341
"1434",2017-11-03,"New Orleans Pelicans",99,"Dallas Mavericks",94,19894,0,-5,5,"2017-18",36.5853658536585
"1435",2017-11-03,"Charlotte Hornets",101,"San Antonio Spurs",108,18418,1,7,7,"2017-18",79.0697674418605
"1436",2017-11-03,"Miami Heat",94,"Denver Nuggets",95,15317,1,1,1,"2017-18",75.609756097561
"1437",2017-11-03,"Toronto Raptors",109,"Utah Jazz",100,16258,0,-9,9,"2017-18",67.3913043478261
"1438",2017-11-03,"Boston Celtics",101,"Oklahoma City Thunder",94,18203,0,-7,7,"2017-18",65.9090909090909
"1439",2017-11-03,"Brooklyn Nets",112,"Los Angeles Lakers",124,18997,1,12,12,"2017-18",48.780487804878
"1440",2017-11-04,"Memphis Grizzlies",113,"Los Angeles Clippers",104,14777,0,-9,9,"2017-18",53.6585365853659
"1441",2017-11-04,"Sacramento Kings",99,"Detroit Pistons",108,17683,1,9,9,"2017-18",60.9756097560976
"1442",2017-11-04,"New Orleans Pelicans",96,"Chicago Bulls",90,21254,0,-6,6,"2017-18",41.4634146341463
"1443",2017-11-04,"Dallas Mavericks",99,"Minnesota Timberwolves",112,16837,1,13,13,"2017-18",72.0930232558139
"1444",2017-11-04,"Golden State Warriors",127,"Denver Nuggets",108,19711,0,-19,19,"2017-18",75.609756097561
"1445",2017-11-05,"Atlanta Hawks",117,"Cleveland Cavaliers",115,20562,0,-2,2,"2017-18",71.1538461538462
"1446",2017-11-05,"Miami Heat",104,"Los Angeles Clippers",101,15676,0,-3,3,"2017-18",53.6585365853659
"1447",2017-11-05,"Boston Celtics",104,"Orlando Magic",88,17731,0,-16,16,"2017-18",41.4634146341463
"1448",2017-11-05,"Washington Wizards",107,"Toronto Raptors",96,19800,0,-11,11,"2017-18",80.4347826086957
"1449",2017-11-05,"Utah Jazz",110,"Houston Rockets",137,16914,1,27,27,"2017-18",80.3921568627451
"1450",2017-11-05,"Phoenix Suns",95,"San Antonio Spurs",112,18038,1,17,17,"2017-18",79.0697674418605
"1451",2017-11-05,"Indiana Pacers",101,"New York Knicks",108,17889,1,7,7,"2017-18",46.3414634146341
"1452",2017-11-05,"Charlotte Hornets",94,"Minnesota Timberwolves",112,14124,1,18,18,"2017-18",72.0930232558139
"1453",2017-11-05,"Oklahoma City Thunder",99,"Portland Trail Blazers",103,19393,1,4,4,"2017-18",65.1162790697674
"1454",2017-11-05,"Memphis Grizzlies",102,"Los Angeles Lakers",107,18997,1,5,5,"2017-18",48.780487804878
"1455",2017-11-06,"Boston Celtics",110,"Atlanta Hawks",107,13215,0,-3,3,"2017-18",39.0243902439024
"1456",2017-11-06,"Brooklyn Nets",98,"Phoenix Suns",92,15905,0,-6,6,"2017-18",24.390243902439
"1457",2017-11-06,"Miami Heat",80,"Golden State Warriors",97,19596,1,17,17,"2017-18",75
"1458",2017-11-07,"Milwaukee Bucks",119,"Cleveland Cavaliers",124,20562,1,5,5,"2017-18",71.1538461538462
"1459",2017-11-07,"New Orleans Pelicans",117,"Indiana Pacers",112,15014,0,-5,5,"2017-18",65.9090909090909
"1460",2017-11-07,"Dallas Mavericks",113,"Washington Wizards",99,14505,0,-14,14,"2017-18",56.8181818181818
"1461",2017-11-07,"Charlotte Hornets",113,"New York Knicks",118,18704,1,5,5,"2017-18",46.3414634146341
"1462",2017-11-07,"Chicago Bulls",114,"Toronto Raptors",119,19800,1,5,5,"2017-18",80.4347826086957
"1463",2017-11-07,"Los Angeles Clippers",107,"San Antonio Spurs",120,18418,1,13,13,"2017-18",79.0697674418605
"1464",2017-11-07,"Brooklyn Nets",104,"Denver Nuggets",112,14058,1,8,8,"2017-18",75.609756097561
"1465",2017-11-07,"Philadelphia 76ers",104,"Utah Jazz",97,16063,0,-7,7,"2017-18",67.3913043478261
"1466",2017-11-07,"Memphis Grizzlies",98,"Portland Trail Blazers",97,18692,0,-1,1,"2017-18",65.1162790697674
"1467",2017-11-07,"Oklahoma City Thunder",86,"Sacramento Kings",94,17583,1,8,8,"2017-18",34.1463414634146
"1468",2017-11-08,"Indiana Pacers",97,"Detroit Pistons",114,14407,1,17,17,"2017-18",60.9756097560976
"1469",2017-11-08,"New York Knicks",99,"Orlando Magic",112,18803,1,13,13,"2017-18",41.4634146341463
"1470",2017-11-08,"Los Angeles Lakers",96,"Boston Celtics",107,18624,1,11,11,"2017-18",71.1538461538462
"1471",2017-11-08,"Miami Heat",126,"Phoenix Suns",115,16500,0,-11,11,"2017-18",24.390243902439
"1472",2017-11-08,"Minnesota Timberwolves",101,"Golden State Warriors",125,19596,1,24,24,"2017-18",75
"1473",2017-11-09,"Los Angeles Lakers",95,"Washington Wizards",111,20356,1,16,16,"2017-18",56.8181818181818
"1474",2017-11-09,"New Orleans Pelicans",118,"Toronto Raptors",122,19800,1,4,4,"2017-18",80.4347826086957
"1475",2017-11-09,"Cleveland Cavaliers",113,"Houston Rockets",117,18055,1,4,4,"2017-18",80.3921568627451
"1476",2017-11-09,"Philadelphia 76ers",108,"Sacramento Kings",109,17583,1,1,1,"2017-18",34.1463414634146
"1477",2017-11-09,"Oklahoma City Thunder",94,"Denver Nuggets",102,19520,1,8,8,"2017-18",75.609756097561
"1478",2017-11-10,"Atlanta Hawks",104,"Detroit Pistons",111,16687,1,7,7,"2017-18",60.9756097560976
"1479",2017-11-10,"Charlotte Hornets",87,"Boston Celtics",90,18624,1,3,3,"2017-18",71.1538461538462
"1480",2017-11-10,"Indiana Pacers",105,"Chicago Bulls",87,22416,0,-18,18,"2017-18",41.4634146341463
"1481",2017-11-10,"Los Angeles Clippers",111,"Oklahoma City Thunder",120,18203,1,9,9,"2017-18",65.9090909090909
"1482",2017-11-10,"Orlando Magic",128,"Phoenix Suns",112,16507,0,-16,16,"2017-18",24.390243902439
"1483",2017-11-10,"Milwaukee Bucks",94,"San Antonio Spurs",87,18418,0,-7,7,"2017-18",79.0697674418605
"1484",2017-11-10,"Miami Heat",84,"Utah Jazz",74,18306,0,-10,10,"2017-18",67.3913043478261
"1485",2017-11-10,"Brooklyn Nets",101,"Portland Trail Blazers",97,19393,0,-4,4,"2017-18",65.1162790697674
"1486",2017-11-11,"Los Angeles Clippers",103,"New Orleans Pelicans",111,17624,1,8,8,"2017-18",60
"1487",2017-11-11,"Atlanta Hawks",94,"Washington Wizards",113,17260,1,19,19,"2017-18",56.8181818181818
"1488",2017-11-11,"Memphis Grizzlies",96,"Houston Rockets",111,18055,1,15,15,"2017-18",80.3921568627451
"1489",2017-11-11,"Sacramento Kings",91,"New York Knicks",118,19812,1,27,27,"2017-18",46.3414634146341
"1490",2017-11-11,"Cleveland Cavaliers",111,"Dallas Mavericks",104,20378,0,-7,7,"2017-18",36.5853658536585
"1491",2017-11-11,"Philadelphia 76ers",114,"Golden State Warriors",135,19596,1,21,21,"2017-18",75
"1492",2017-11-11,"Los Angeles Lakers",90,"Milwaukee Bucks",98,18717,1,8,8,"2017-18",63.6363636363636
"1493",2017-11-11,"Chicago Bulls",94,"San Antonio Spurs",133,18418,1,39,39,"2017-18",79.0697674418605
"1494",2017-11-11,"Orlando Magic",107,"Denver Nuggets",125,16688,1,18,18,"2017-18",75.609756097561
"1495",2017-11-11,"Minnesota Timberwolves",110,"Phoenix Suns",118,16910,1,8,8,"2017-18",24.390243902439
"1496",2017-11-11,"Brooklyn Nets",106,"Utah Jazz",114,17413,1,8,8,"2017-18",67.3913043478261
"1497",2017-11-12,"Toronto Raptors",94,"Boston Celtics",95,18624,1,1,1,"2017-18",71.1538461538462
"1498",2017-11-12,"Miami Heat",103,"Detroit Pistons",112,16236,1,9,9,"2017-18",60.9756097560976
"1499",2017-11-12,"Houston Rockets",118,"Indiana Pacers",95,15581,0,-23,23,"2017-18",65.9090909090909
"1500",2017-11-12,"Dallas Mavericks",99,"Oklahoma City Thunder",112,18203,1,13,13,"2017-18",65.9090909090909
"1501",2017-11-13,"Sacramento Kings",92,"Washington Wizards",110,14660,1,18,18,"2017-18",56.8181818181818
"1502",2017-11-13,"Cleveland Cavaliers",104,"New York Knicks",101,19812,0,-3,3,"2017-18",46.3414634146341
"1503",2017-11-13,"Memphis Grizzlies",103,"Milwaukee Bucks",110,13244,1,7,7,"2017-18",63.6363636363636
"1504",2017-11-13,"Atlanta Hawks",105,"New Orleans Pelicans",106,14631,1,1,1,"2017-18",60
"1505",2017-11-13,"Los Angeles Lakers",100,"Phoenix Suns",93,17533,0,-7,7,"2017-18",24.390243902439
"1506",2017-11-13,"Minnesota Timberwolves",109,"Utah Jazz",98,17236,0,-11,11,"2017-18",67.3913043478261
"1507",2017-11-13,"Denver Nuggets",82,"Portland Trail Blazers",99,18895,1,17,17,"2017-18",65.1162790697674
"1508",2017-11-13,"Orlando Magic",100,"Golden State Warriors",110,19596,1,10,10,"2017-18",75
"1509",2017-11-13,"Philadelphia 76ers",109,"Los Angeles Clippers",105,19068,0,-4,4,"2017-18",53.6585365853659
"1510",2017-11-14,"Boston Celtics",109,"Brooklyn Nets",102,17732,0,-7,7,"2017-18",36.5853658536585
"1511",2017-11-14,"Toronto Raptors",129,"Houston Rockets",113,18055,0,-16,16,"2017-18",80.3921568627451
"1512",2017-11-14,"San Antonio Spurs",97,"Dallas Mavericks",91,19535,0,-6,6,"2017-18",36.5853658536585
"1513",2017-11-15,"Sacramento Kings",80,"Atlanta Hawks",126,13860,1,46,46,"2017-18",39.0243902439024
"1514",2017-11-15,"Washington Wizards",102,"Miami Heat",93,19600,0,-9,9,"2017-18",60.4651162790698
"1515",2017-11-15,"Utah Jazz",101,"New York Knicks",106,18695,1,5,5,"2017-18",46.3414634146341
"1516",2017-11-15,"Cleveland Cavaliers",115,"Charlotte Hornets",107,19427,0,-8,8,"2017-18",51.219512195122
"1517",2017-11-15,"Indiana Pacers",116,"Memphis Grizzlies",113,16033,0,-3,3,"2017-18",39.0243902439024
"1518",2017-11-15,"Detroit Pistons",95,"Milwaukee Bucks",99,14594,1,4,4,"2017-18",63.6363636363636
"1519",2017-11-15,"San Antonio Spurs",86,"Minnesota Timberwolves",98,18978,1,12,12,"2017-18",72.0930232558139
"1520",2017-11-15,"Toronto Raptors",125,"New Orleans Pelicans",116,15654,0,-9,9,"2017-18",60
"1521",2017-11-15,"Chicago Bulls",79,"Oklahoma City Thunder",92,18203,1,13,13,"2017-18",65.9090909090909
"1522",2017-11-15,"Orlando Magic",94,"Portland Trail Blazers",99,19206,1,5,5,"2017-18",65.1162790697674
"1523",2017-11-15,"Philadelphia 76ers",115,"Los Angeles Lakers",109,18997,0,-6,6,"2017-18",48.780487804878
"1524",2017-11-16,"Golden State Warriors",88,"Boston Celtics",92,18624,1,4,4,"2017-18",71.1538461538462
"1525",2017-11-16,"Houston Rockets",142,"Phoenix Suns",116,16875,0,-26,26,"2017-18",24.390243902439
"1526",2017-11-17,"Detroit Pistons",100,"Indiana Pacers",107,17188,1,7,7,"2017-18",65.9090909090909
"1527",2017-11-17,"Miami Heat",91,"Washington Wizards",88,17551,0,-3,3,"2017-18",56.8181818181818
"1528",2017-11-17,"Utah Jazz",107,"Brooklyn Nets",118,14495,1,11,11,"2017-18",36.5853658536585
"1529",2017-11-17,"Los Angeles Clippers",113,"Cleveland Cavaliers",118,20562,1,5,5,"2017-18",71.1538461538462
"1530",2017-11-17,"New York Knicks",84,"Toronto Raptors",107,19800,1,23,23,"2017-18",80.4347826086957
"1531",2017-11-17,"Charlotte Hornets",120,"Chicago Bulls",123,20493,1,3,3,"2017-18",41.4634146341463
"1532",2017-11-17,"Oklahoma City Thunder",101,"San Antonio Spurs",104,18418,1,3,3,"2017-18",79.0697674418605
"1533",2017-11-17,"Minnesota Timberwolves",111,"Dallas Mavericks",87,19459,0,-24,24,"2017-18",36.5853658536585
"1534",2017-11-17,"Portland Trail Blazers",82,"Sacramento Kings",86,17583,1,4,4,"2017-18",34.1463414634146
"1535",2017-11-17,"New Orleans Pelicans",114,"Denver Nuggets",146,16816,1,32,32,"2017-18",75.609756097561
"1536",2017-11-17,"Phoenix Suns",122,"Los Angeles Lakers",113,18997,0,-9,9,"2017-18",48.780487804878
"1537",2017-11-18,"Los Angeles Clippers",87,"Charlotte Hornets",102,17640,1,15,15,"2017-18",51.219512195122
"1538",2017-11-18,"Utah Jazz",125,"Orlando Magic",85,19157,0,-40,40,"2017-18",41.4634146341463
"1539",2017-11-18,"Boston Celtics",110,"Atlanta Hawks",99,16381,0,-11,11,"2017-18",39.0243902439024
"1540",2017-11-18,"Golden State Warriors",124,"Philadelphia 76ers",116,20848,0,-8,8,"2017-18",71.7391304347826
"1541",2017-11-18,"Houston Rockets",105,"Memphis Grizzlies",83,17266,0,-22,22,"2017-18",39.0243902439024
"1542",2017-11-18,"Milwaukee Bucks",79,"Dallas Mavericks",111,19949,1,32,32,"2017-18",36.5853658536585
"1543",2017-11-18,"Sacramento Kings",90,"Portland Trail Blazers",102,19522,1,12,12,"2017-18",65.1162790697674
"1544",2017-11-19,"Washington Wizards",91,"Toronto Raptors",100,19800,1,9,9,"2017-18",80.4347826086957
"1545",2017-11-19,"Indiana Pacers",120,"Miami Heat",95,19600,0,-25,25,"2017-18",60.4651162790698
"1546",2017-11-19,"Golden State Warriors",118,"Brooklyn Nets",111,17732,0,-7,7,"2017-18",36.5853658536585
"1547",2017-11-19,"Detroit Pistons",100,"Minnesota Timberwolves",97,16069,0,-3,3,"2017-18",72.0930232558139
"1548",2017-11-19,"Chicago Bulls",105,"Phoenix Suns",113,16264,1,8,8,"2017-18",24.390243902439
"1549",2017-11-19,"Denver Nuggets",109,"Los Angeles Lakers",127,18997,1,18,18,"2017-18",48.780487804878
"1550",2017-11-20,"Minnesota Timberwolves",102,"Charlotte Hornets",118,15978,1,16,16,"2017-18",51.219512195122
"1551",2017-11-20,"Cleveland Cavaliers",116,"Detroit Pistons",88,20491,0,-28,28,"2017-18",60.9756097560976
"1552",2017-11-20,"Indiana Pacers",105,"Orlando Magic",97,17239,0,-8,8,"2017-18",41.4634146341463
"1553",2017-11-20,"Utah Jazz",86,"Philadelphia 76ers",107,20587,1,21,21,"2017-18",71.7391304347826
"1554",2017-11-20,"Los Angeles Clippers",85,"New York Knicks",107,18848,1,22,22,"2017-18",46.3414634146341
"1555",2017-11-20,"Portland Trail Blazers",100,"Memphis Grizzlies",92,15785,0,-8,8,"2017-18",39.0243902439024
"1556",2017-11-20,"Washington Wizards",99,"Milwaukee Bucks",88,16122,0,-11,11,"2017-18",63.6363636363636
"1557",2017-11-20,"Oklahoma City Thunder",107,"New Orleans Pelicans",114,16765,1,7,7,"2017-18",60
"1558",2017-11-20,"Boston Celtics",110,"Dallas Mavericks",102,20302,0,-8,8,"2017-18",36.5853658536585
"1559",2017-11-20,"Atlanta Hawks",85,"San Antonio Spurs",96,18418,1,11,11,"2017-18",79.0697674418605
"1560",2017-11-20,"Denver Nuggets",114,"Sacramento Kings",98,17583,0,-16,16,"2017-18",34.1463414634146
"1561",2017-11-21,"Chicago Bulls",94,"Los Angeles Lakers",103,18997,1,9,9,"2017-18",48.780487804878
"1562",2017-11-22,"Washington Wizards",124,"Charlotte Hornets",129,16041,1,5,5,"2017-18",51.219512195122
"1563",2017-11-22,"Brooklyn Nets",109,"Cleveland Cavaliers",119,20562,1,10,10,"2017-18",71.1538461538462
"1564",2017-11-22,"Portland Trail Blazers",81,"Philadelphia 76ers",101,20605,1,20,20,"2017-18",71.7391304347826
"1565",2017-11-22,"Los Angeles Clippers",116,"Atlanta Hawks",103,12675,0,-13,13,"2017-18",39.0243902439024
"1566",2017-11-22,"Boston Celtics",98,"Miami Heat",104,19704,1,6,6,"2017-18",60.4651162790698
"1567",2017-11-22,"Toronto Raptors",100,"New York Knicks",108,19812,1,8,8,"2017-18",46.3414634146341
"1568",2017-11-22,"Denver Nuggets",95,"Houston Rockets",125,18055,1,30,30,"2017-18",80.3921568627451
"1569",2017-11-22,"Dallas Mavericks",95,"Memphis Grizzlies",94,16101,0,-1,1,"2017-18",39.0243902439024
"1570",2017-11-22,"Orlando Magic",118,"Minnesota Timberwolves",124,16402,1,6,6,"2017-18",72.0930232558139
"1571",2017-11-22,"San Antonio Spurs",90,"New Orleans Pelicans",107,17539,1,17,17,"2017-18",60
"1572",2017-11-22,"Golden State Warriors",91,"Oklahoma City Thunder",108,18203,1,17,17,"2017-18",65.9090909090909
"1573",2017-11-22,"Milwaukee Bucks",113,"Phoenix Suns",107,16270,0,-6,6,"2017-18",24.390243902439
"1574",2017-11-22,"Chicago Bulls",80,"Utah Jazz",110,17434,1,30,30,"2017-18",67.3913043478261
"1575",2017-11-22,"Los Angeles Lakers",102,"Sacramento Kings",113,17583,1,11,11,"2017-18",34.1463414634146
"1576",2017-11-24,"Portland Trail Blazers",127,"Brooklyn Nets",125,15246,0,-2,2,"2017-18",36.5853658536585
"1577",2017-11-24,"New York Knicks",104,"Atlanta Hawks",116,14355,1,12,12,"2017-18",39.0243902439024
"1578",2017-11-24,"Orlando Magic",103,"Boston Celtics",118,18624,1,15,15,"2017-18",71.1538461538462
"1579",2017-11-24,"Charlotte Hornets",99,"Cleveland Cavaliers",100,20562,1,1,1,"2017-18",71.1538461538462
"1580",2017-11-24,"Toronto Raptors",104,"Indiana Pacers",107,16523,1,3,3,"2017-18",65.9090909090909
"1581",2017-11-24,"Miami Heat",109,"Minnesota Timberwolves",97,18978,0,-12,12,"2017-18",72.0930232558139
"1582",2017-11-24,"Detroit Pistons",99,"Oklahoma City Thunder",98,18203,0,-1,1,"2017-18",65.9090909090909
"1583",2017-11-24,"Memphis Grizzlies",92,"Denver Nuggets",104,16736,1,12,12,"2017-18",75.609756097561
"1584",2017-11-24,"New Orleans Pelicans",115,"Phoenix Suns",91,16574,0,-24,24,"2017-18",24.390243902439
"1585",2017-11-24,"Chicago Bulls",94,"Golden State Warriors",143,19596,1,49,49,"2017-18",75
"1586",2017-11-25,"San Antonio Spurs",106,"Charlotte Hornets",86,18597,0,-20,20,"2017-18",51.219512195122
"1587",2017-11-25,"Orlando Magic",111,"Philadelphia 76ers",130,20585,1,19,19,"2017-18",71.7391304347826
"1588",2017-11-25,"Portland Trail Blazers",108,"Washington Wizards",105,18092,0,-3,3,"2017-18",56.8181818181818
"1589",2017-11-25,"Toronto Raptors",112,"Atlanta Hawks",78,12278,0,-34,34,"2017-18",39.0243902439024
"1590",2017-11-25,"New York Knicks",102,"Houston Rockets",117,18055,1,15,15,"2017-18",80.3921568627451
"1591",2017-11-25,"Boston Celtics",108,"Indiana Pacers",98,16303,0,-10,10,"2017-18",65.9090909090909
"1592",2017-11-25,"Oklahoma City Thunder",81,"Dallas Mavericks",97,20340,1,16,16,"2017-18",36.5853658536585
"1593",2017-11-25,"New Orleans Pelicans",95,"Golden State Warriors",110,19596,1,15,15,"2017-18",75
"1594",2017-11-25,"Milwaukee Bucks",108,"Utah Jazz",121,17298,1,13,13,"2017-18",67.3913043478261
"1595",2017-11-25,"Los Angeles Clippers",97,"Sacramento Kings",95,17583,0,-2,2,"2017-18",34.1463414634146
"1596",2017-11-26,"Miami Heat",100,"Chicago Bulls",93,20928,0,-7,7,"2017-18",41.4634146341463
"1597",2017-11-26,"Phoenix Suns",108,"Minnesota Timberwolves",119,16448,1,11,11,"2017-18",72.0930232558139
"1598",2017-11-26,"Brooklyn Nets",98,"Memphis Grizzlies",88,14889,0,-10,10,"2017-18",39.0243902439024
"1599",2017-11-27,"Orlando Magic",109,"Indiana Pacers",121,12501,1,12,12,"2017-18",65.9090909090909
"1600",2017-11-27,"Cleveland Cavaliers",113,"Philadelphia 76ers",91,20527,0,-22,22,"2017-18",71.7391304347826
"1601",2017-11-27,"Detroit Pistons",118,"Boston Celtics",108,18624,0,-10,10,"2017-18",71.1538461538462
"1602",2017-11-27,"Portland Trail Blazers",103,"New York Knicks",91,18409,0,-12,12,"2017-18",46.3414634146341
"1603",2017-11-27,"Brooklyn Nets",103,"Houston Rockets",117,16189,1,14,14,"2017-18",80.3921568627451
"1604",2017-11-27,"Dallas Mavericks",108,"San Antonio Spurs",115,17918,1,7,7,"2017-18",79.0697674418605
"1605",2017-11-27,"Sacramento Kings",110,"Golden State Warriors",106,19596,0,-4,4,"2017-18",75
"1606",2017-11-27,"Los Angeles Lakers",115,"Los Angeles Clippers",120,18086,1,5,5,"2017-18",53.6585365853659
"1607",2017-11-28,"Miami Heat",97,"Cleveland Cavaliers",108,20562,1,11,11,"2017-18",71.1538461538462
"1608",2017-11-28,"Phoenix Suns",104,"Chicago Bulls",99,18324,0,-5,5,"2017-18",41.4634146341463
"1609",2017-11-28,"Washington Wizards",92,"Minnesota Timberwolves",89,13442,0,-3,3,"2017-18",72.0930232558139
"1610",2017-11-28,"Milwaukee Bucks",112,"Sacramento Kings",87,17583,0,-25,25,"2017-18",34.1463414634146
"1611",2017-11-28,"Denver Nuggets",77,"Utah Jazz",106,16790,1,29,29,"2017-18",67.3913043478261
"1612",2017-11-29,"Phoenix Suns",107,"Detroit Pistons",131,18096,1,24,24,"2017-18",60.9756097560976
"1613",2017-11-29,"Oklahoma City Thunder",108,"Orlando Magic",121,17797,1,13,13,"2017-18",41.4634146341463
"1614",2017-11-29,"Washington Wizards",113,"Philadelphia 76ers",118,20492,1,5,5,"2017-18",71.7391304347826
"1615",2017-11-29,"Miami Heat",86,"New York Knicks",115,17693,1,29,29,"2017-18",46.3414634146341
"1616",2017-11-29,"Charlotte Hornets",113,"Toronto Raptors",126,19800,1,13,13,"2017-18",80.4347826086957
"1617",2017-11-29,"Indiana Pacers",97,"Houston Rockets",118,16760,1,21,21,"2017-18",80.3921568627451
"1618",2017-11-29,"Minnesota Timberwolves",120,"New Orleans Pelicans",102,15555,0,-18,18,"2017-18",60
"1619",2017-11-29,"Brooklyn Nets",109,"Dallas Mavericks",104,19327,0,-5,5,"2017-18",36.5853658536585
"1620",2017-11-29,"Memphis Grizzlies",95,"San Antonio Spurs",104,18013,1,9,9,"2017-18",79.0697674418605
"1621",2017-11-29,"Golden State Warriors",127,"Los Angeles Lakers",123,18997,0,-4,4,"2017-18",48.780487804878
"1622",2017-11-30,"Cleveland Cavaliers",121,"Atlanta Hawks",114,16379,0,-7,7,"2017-18",39.0243902439024
"1623",2017-11-30,"Philadelphia 76ers",97,"Boston Celtics",108,18624,1,11,11,"2017-18",71.1538461538462
"1624",2017-11-30,"Chicago Bulls",110,"Denver Nuggets",111,15156,1,1,1,"2017-18",75.609756097561
"1625",2017-11-30,"Milwaukee Bucks",103,"Portland Trail Blazers",91,19459,0,-12,12,"2017-18",65.1162790697674
"1626",2017-11-30,"Utah Jazz",126,"Los Angeles Clippers",107,15139,0,-19,19,"2017-18",53.6585365853659
"1627",2017-12-01,"Golden State Warriors",133,"Orlando Magic",112,18846,0,-21,21,"2017-18",41.4634146341463
"1628",2017-12-01,"Detroit Pistons",91,"Washington Wizards",109,17885,1,18,18,"2017-18",56.8181818181818
"1629",2017-12-01,"Indiana Pacers",115,"Toronto Raptors",120,19800,1,5,5,"2017-18",80.4347826086957
"1630",2017-12-01,"Sacramento Kings",107,"Chicago Bulls",106,19268,0,-1,1,"2017-18",41.4634146341463
"1631",2017-12-01,"San Antonio Spurs",95,"Memphis Grizzlies",79,16413,0,-16,16,"2017-18",39.0243902439024
"1632",2017-12-01,"Charlotte Hornets",100,"Miami Heat",105,19600,1,5,5,"2017-18",60.4651162790698
"1633",2017-12-01,"Minnesota Timberwolves",107,"Oklahoma City Thunder",111,18203,1,4,4,"2017-18",65.9090909090909
"1634",2017-12-01,"New Orleans Pelicans",108,"Utah Jazz",114,17725,1,6,6,"2017-18",67.3913043478261
"1635",2017-12-02,"Phoenix Suns",111,"Boston Celtics",116,18624,1,5,5,"2017-18",71.1538461538462
"1636",2017-12-02,"Los Angeles Clippers",82,"Dallas Mavericks",108,19245,1,26,26,"2017-18",36.5853658536585
"1637",2017-12-02,"Atlanta Hawks",114,"Brooklyn Nets",102,13949,0,-12,12,"2017-18",36.5853658536585
"1638",2017-12-02,"Memphis Grizzlies",111,"Cleveland Cavaliers",116,20562,1,5,5,"2017-18",71.1538461538462
"1639",2017-12-02,"Detroit Pistons",103,"Philadelphia 76ers",108,20562,1,5,5,"2017-18",71.7391304347826
"1640",2017-12-02,"Sacramento Kings",104,"Milwaukee Bucks",109,15581,1,5,5,"2017-18",63.6363636363636
"1641",2017-12-02,"Los Angeles Lakers",100,"Denver Nuggets",115,19520,1,15,15,"2017-18",75.609756097561
"1642",2017-12-02,"New Orleans Pelicans",123,"Portland Trail Blazers",116,18730,0,-7,7,"2017-18",65.1162790697674
"1643",2017-12-03,"Orlando Magic",105,"New York Knicks",100,19082,0,-5,5,"2017-18",46.3414634146341
"1644",2017-12-03,"Golden State Warriors",123,"Miami Heat",95,19600,0,-28,28,"2017-18",60.4651162790698
"1645",2017-12-03,"Los Angeles Clippers",106,"Minnesota Timberwolves",112,13172,1,6,6,"2017-18",72.0930232558139
"1646",2017-12-03,"San Antonio Spurs",87,"Oklahoma City Thunder",90,18203,1,3,3,"2017-18",65.9090909090909
"1647",2017-12-03,"Houston Rockets",118,"Los Angeles Lakers",95,18997,0,-23,23,"2017-18",48.780487804878
"1648",2017-12-04,"Orlando Magic",94,"Charlotte Hornets",104,14419,1,10,10,"2017-18",51.219512195122
"1649",2017-12-04,"New York Knicks",97,"Indiana Pacers",115,12018,1,18,18,"2017-18",65.9090909090909
"1650",2017-12-04,"Phoenix Suns",115,"Philadelphia 76ers",101,20564,0,-14,14,"2017-18",71.7391304347826
"1651",2017-12-04,"Brooklyn Nets",110,"Atlanta Hawks",90,12056,0,-20,20,"2017-18",39.0243902439024
"1652",2017-12-04,"Milwaukee Bucks",100,"Boston Celtics",111,18624,1,11,11,"2017-18",71.1538461538462
"1653",2017-12-04,"Cleveland Cavaliers",113,"Chicago Bulls",91,21323,0,-22,22,"2017-18",41.4634146341463
"1654",2017-12-04,"Minnesota Timberwolves",92,"Memphis Grizzlies",95,14012,1,3,3,"2017-18",39.0243902439024
"1655",2017-12-04,"Golden State Warriors",125,"New Orleans Pelicans",115,17004,0,-10,10,"2017-18",60
"1656",2017-12-04,"Denver Nuggets",105,"Dallas Mavericks",122,19419,1,17,17,"2017-18",36.5853658536585
"1657",2017-12-04,"Detroit Pistons",93,"San Antonio Spurs",96,18288,1,3,3,"2017-18",79.0697674418605
"1658",2017-12-04,"Washington Wizards",69,"Utah Jazz",116,17227,1,47,47,"2017-18",67.3913043478261
"1659",2017-12-05,"Phoenix Suns",113,"Toronto Raptors",126,19800,1,13,13,"2017-18",80.4347826086957
"1660",2017-12-05,"Utah Jazz",94,"Oklahoma City Thunder",100,18203,1,6,6,"2017-18",65.9090909090909
"1661",2017-12-05,"Washington Wizards",106,"Portland Trail Blazers",92,19241,0,-14,14,"2017-18",65.1162790697674
"1662",2017-12-06,"Sacramento Kings",95,"Cleveland Cavaliers",101,20562,1,6,6,"2017-18",71.1538461538462
"1663",2017-12-06,"Chicago Bulls",96,"Indiana Pacers",98,13013,1,2,2,"2017-18",65.9090909090909
"1664",2017-12-06,"Atlanta Hawks",106,"Orlando Magic",110,16167,1,4,4,"2017-18",41.4634146341463
"1665",2017-12-06,"Dallas Mavericks",90,"Boston Celtics",97,18624,1,7,7,"2017-18",71.1538461538462
"1666",2017-12-06,"Memphis Grizzlies",88,"New York Knicks",99,19812,1,11,11,"2017-18",46.3414634146341
"1667",2017-12-06,"Golden State Warriors",101,"Charlotte Hornets",87,19334,0,-14,14,"2017-18",51.219512195122
"1668",2017-12-06,"Detroit Pistons",100,"Milwaukee Bucks",104,15841,1,4,4,"2017-18",63.6363636363636
"1669",2017-12-06,"Denver Nuggets",114,"New Orleans Pelicans",123,15353,1,9,9,"2017-18",60
"1670",2017-12-06,"Miami Heat",105,"San Antonio Spurs",117,18252,1,12,12,"2017-18",79.0697674418605
"1671",2017-12-06,"Minnesota Timberwolves",113,"Los Angeles Clippers",107,15951,0,-6,6,"2017-18",53.6585365853659
"1672",2017-12-07,"Los Angeles Lakers",107,"Philadelphia 76ers",104,20495,0,-3,3,"2017-18",71.7391304347826
"1673",2017-12-07,"Washington Wizards",109,"Phoenix Suns",99,15925,0,-10,10,"2017-18",24.390243902439
"1674",2017-12-07,"Oklahoma City Thunder",95,"Brooklyn Nets",100,20562,1,5,5,"2017-18",36.5853658536585
"1675",2017-12-07,"Houston Rockets",112,"Utah Jazz",101,18306,0,-11,11,"2017-18",67.3913043478261
"1676",2017-12-08,"Chicago Bulls",119,"Charlotte Hornets",111,14077,0,-8,8,"2017-18",51.219512195122
"1677",2017-12-08,"Golden State Warriors",102,"Detroit Pistons",98,20491,0,-4,4,"2017-18",60.9756097560976
"1678",2017-12-08,"Cleveland Cavaliers",102,"Indiana Pacers",106,17032,1,4,4,"2017-18",65.9090909090909
"1679",2017-12-08,"Denver Nuggets",103,"Orlando Magic",89,16024,0,-14,14,"2017-18",41.4634146341463
"1680",2017-12-08,"Toronto Raptors",116,"Memphis Grizzlies",107,15417,0,-9,9,"2017-18",39.0243902439024
"1681",2017-12-08,"Dallas Mavericks",102,"Milwaukee Bucks",109,15889,1,7,7,"2017-18",63.6363636363636
"1682",2017-12-08,"Sacramento Kings",116,"New Orleans Pelicans",109,15019,0,-7,7,"2017-18",60
"1683",2017-12-08,"Boston Celtics",102,"San Antonio Spurs",105,18418,1,3,3,"2017-18",79.0697674418605
"1684",2017-12-09,"Washington Wizards",112,"Los Angeles Clippers",113,15739,1,1,1,"2017-18",53.6585365853659
"1685",2017-12-09,"Miami Heat",101,"Brooklyn Nets",89,19777,0,-12,12,"2017-18",36.5853658536585
"1686",2017-12-09,"Los Angeles Lakers",110,"Charlotte Hornets",99,19320,0,-11,11,"2017-18",51.219512195122
"1687",2017-12-09,"Orlando Magic",110,"Atlanta Hawks",117,12719,1,7,7,"2017-18",39.0243902439024
"1688",2017-12-09,"New York Knicks",102,"Chicago Bulls",104,20149,1,2,2,"2017-18",41.4634146341463
"1689",2017-12-09,"Philadelphia 76ers",98,"Cleveland Cavaliers",105,20562,1,7,7,"2017-18",71.1538461538462
"1690",2017-12-09,"Utah Jazz",100,"Milwaukee Bucks",117,16675,1,17,17,"2017-18",63.6363636363636
"1691",2017-12-09,"Oklahoma City Thunder",102,"Memphis Grizzlies",101,17794,0,-1,1,"2017-18",39.0243902439024
"1692",2017-12-09,"San Antonio Spurs",104,"Phoenix Suns",101,16575,0,-3,3,"2017-18",24.390243902439
"1693",2017-12-09,"Houston Rockets",124,"Portland Trail Blazers",117,19503,0,-7,7,"2017-18",65.1162790697674
"1694",2017-12-10,"Toronto Raptors",102,"Sacramento Kings",87,17583,0,-15,15,"2017-18",34.1463414634146
"1695",2017-12-10,"Boston Celtics",91,"Detroit Pistons",81,18776,0,-10,10,"2017-18",60.9756097560976
"1696",2017-12-10,"Denver Nuggets",116,"Indiana Pacers",126,14587,1,10,10,"2017-18",65.9090909090909
"1697",2017-12-10,"Dallas Mavericks",92,"Minnesota Timberwolves",97,13094,1,5,5,"2017-18",72.0930232558139
"1698",2017-12-10,"Philadelphia 76ers",124,"New Orleans Pelicans",131,16878,1,7,7,"2017-18",60
"1699",2017-12-10,"Atlanta Hawks",107,"New York Knicks",111,19189,1,4,4,"2017-18",46.3414634146341
"1700",2017-12-11,"Boston Celtics",85,"Chicago Bulls",108,19617,1,23,23,"2017-18",41.4634146341463
"1701",2017-12-11,"New Orleans Pelicans",123,"Houston Rockets",130,18055,1,7,7,"2017-18",80.3921568627451
"1702",2017-12-11,"Miami Heat",107,"Memphis Grizzlies",82,14857,0,-25,25,"2017-18",39.0243902439024
"1703",2017-12-11,"Charlotte Hornets",116,"Oklahoma City Thunder",103,18203,0,-13,13,"2017-18",65.9090909090909
"1704",2017-12-11,"Portland Trail Blazers",104,"Golden State Warriors",111,19596,1,7,7,"2017-18",75
"1705",2017-12-11,"Toronto Raptors",91,"Los Angeles Clippers",96,16658,1,5,5,"2017-18",53.6585365853659
"1706",2017-12-12,"Atlanta Hawks",114,"Cleveland Cavaliers",123,20562,1,9,9,"2017-18",71.1538461538462
"1707",2017-12-12,"Denver Nuggets",103,"Detroit Pistons",84,15480,0,-19,19,"2017-18",60.9756097560976
"1708",2017-12-12,"Los Angeles Lakers",109,"New York Knicks",113,19359,1,4,4,"2017-18",46.3414634146341
"1709",2017-12-12,"Washington Wizards",98,"Brooklyn Nets",103,14515,1,5,5,"2017-18",36.5853658536585
"1710",2017-12-12,"San Antonio Spurs",89,"Dallas Mavericks",95,19874,1,6,6,"2017-18",36.5853658536585
"1711",2017-12-12,"Philadelphia 76ers",118,"Minnesota Timberwolves",112,14659,0,-6,6,"2017-18",72.0930232558139
"1712",2017-12-12,"Phoenix Suns",92,"Sacramento Kings",99,17583,1,7,7,"2017-18",34.1463414634146
"1713",2017-12-13,"Oklahoma City Thunder",100,"Indiana Pacers",95,17923,0,-5,5,"2017-18",65.9090909090909
"1714",2017-12-13,"Los Angeles Clippers",106,"Orlando Magic",95,16011,0,-11,11,"2017-18",41.4634146341463
"1715",2017-12-13,"Memphis Grizzlies",87,"Washington Wizards",93,15297,1,6,6,"2017-18",56.8181818181818
"1716",2017-12-13,"Denver Nuggets",118,"Boston Celtics",124,18624,1,6,6,"2017-18",71.1538461538462
"1717",2017-12-13,"Portland Trail Blazers",102,"Miami Heat",95,19600,0,-7,7,"2017-18",60.4651162790698
"1718",2017-12-13,"Utah Jazz",100,"Chicago Bulls",103,18102,1,3,3,"2017-18",41.4634146341463
"1719",2017-12-13,"Milwaukee Bucks",108,"New Orleans Pelicans",115,16863,1,7,7,"2017-18",60
"1720",2017-12-13,"Toronto Raptors",115,"Phoenix Suns",109,15517,0,-6,6,"2017-18",24.390243902439
"1721",2017-12-13,"Charlotte Hornets",96,"Houston Rockets",108,16509,1,12,12,"2017-18",80.3921568627451
"1722",2017-12-14,"Detroit Pistons",105,"Atlanta Hawks",91,13548,0,-14,14,"2017-18",39.0243902439024
"1723",2017-12-14,"New York Knicks",111,"Brooklyn Nets",104,17732,0,-7,7,"2017-18",36.5853658536585
"1724",2017-12-14,"Los Angeles Lakers",112,"Cleveland Cavaliers",121,20562,1,9,9,"2017-18",71.1538461538462
"1725",2017-12-14,"Sacramento Kings",96,"Minnesota Timberwolves",119,11126,1,23,23,"2017-18",72.0930232558139
"1726",2017-12-14,"Dallas Mavericks",97,"Golden State Warriors",112,19596,1,15,15,"2017-18",75
"1727",2017-12-15,"Miami Heat",104,"Charlotte Hornets",98,15565,0,-6,6,"2017-18",51.219512195122
"1728",2017-12-15,"Detroit Pistons",104,"Indiana Pacers",98,14687,0,-6,6,"2017-18",65.9090909090909
"1729",2017-12-15,"Portland Trail Blazers",95,"Orlando Magic",88,16963,0,-7,7,"2017-18",41.4634146341463
"1730",2017-12-15,"Oklahoma City Thunder",119,"Philadelphia 76ers",117,20612,0,-2,2,"2017-18",71.7391304347826
"1731",2017-12-15,"Los Angeles Clippers",91,"Washington Wizards",100,15442,1,9,9,"2017-18",56.8181818181818
"1732",2017-12-15,"Utah Jazz",107,"Boston Celtics",95,18624,0,-12,12,"2017-18",71.1538461538462
"1733",2017-12-15,"Brooklyn Nets",87,"Toronto Raptors",120,19800,1,33,33,"2017-18",80.4347826086957
"1734",2017-12-15,"Atlanta Hawks",94,"Memphis Grizzlies",96,15803,1,2,2,"2017-18",39.0243902439024
"1735",2017-12-15,"Chicago Bulls",115,"Milwaukee Bucks",109,16921,0,-6,6,"2017-18",63.6363636363636
"1736",2017-12-15,"New Orleans Pelicans",111,"Denver Nuggets",117,17584,1,6,6,"2017-18",75.609756097561
"1737",2017-12-15,"San Antonio Spurs",109,"Houston Rockets",124,18055,1,15,15,"2017-18",80.3921568627451
"1738",2017-12-16,"Portland Trail Blazers",93,"Charlotte Hornets",91,16687,0,-2,2,"2017-18",51.219512195122
"1739",2017-12-16,"Utah Jazz",100,"Cleveland Cavaliers",109,20562,1,9,9,"2017-18",71.1538461538462
"1740",2017-12-16,"Oklahoma City Thunder",96,"New York Knicks",111,19812,1,15,15,"2017-18",46.3414634146341
"1741",2017-12-16,"Milwaukee Bucks",111,"Houston Rockets",115,18055,1,4,4,"2017-18",80.3921568627451
"1742",2017-12-16,"Los Angeles Clippers",85,"Miami Heat",90,19600,1,5,5,"2017-18",60.4651162790698
"1743",2017-12-16,"Phoenix Suns",108,"Minnesota Timberwolves",106,18109,0,-2,2,"2017-18",72.0930232558139
"1744",2017-12-16,"Dallas Mavericks",96,"San Antonio Spurs",98,18418,1,2,2,"2017-18",79.0697674418605
"1745",2017-12-16,"Boston Celtics",102,"Memphis Grizzlies",93,17794,0,-9,9,"2017-18",39.0243902439024
"1746",2017-12-17,"Sacramento Kings",93,"Toronto Raptors",108,19800,1,15,15,"2017-18",80.4347826086957
"1747",2017-12-17,"Orlando Magic",110,"Detroit Pistons",114,16312,1,4,4,"2017-18",60.9756097560976
"1748",2017-12-17,"Indiana Pacers",109,"Brooklyn Nets",97,13934,0,-12,12,"2017-18",36.5853658536585
"1749",2017-12-17,"Cleveland Cavaliers",106,"Washington Wizards",99,20356,0,-7,7,"2017-18",56.8181818181818
"1750",2017-12-18,"New York Knicks",91,"Charlotte Hornets",109,15386,1,18,18,"2017-18",51.219512195122
"1751",2017-12-18,"Boston Celtics",112,"Indiana Pacers",111,16055,0,-1,1,"2017-18",65.9090909090909
"1752",2017-12-18,"Miami Heat",104,"Atlanta Hawks",110,14227,1,6,6,"2017-18",39.0243902439024
"1753",2017-12-18,"Philadelphia 76ers",115,"Chicago Bulls",117,20796,1,2,2,"2017-18",41.4634146341463
"1754",2017-12-18,"Utah Jazz",99,"Houston Rockets",120,18055,1,21,21,"2017-18",80.3921568627451
"1755",2017-12-18,"Portland Trail Blazers",107,"Minnesota Timberwolves",108,14187,1,1,1,"2017-18",72.0930232558139
"1756",2017-12-18,"Denver Nuggets",94,"Oklahoma City Thunder",95,18203,1,1,1,"2017-18",65.9090909090909
"1757",2017-12-18,"Phoenix Suns",97,"Dallas Mavericks",91,19245,0,-6,6,"2017-18",36.5853658536585
"1758",2017-12-18,"Los Angeles Clippers",91,"San Antonio Spurs",109,18418,1,18,18,"2017-18",79.0697674418605
"1759",2017-12-18,"Golden State Warriors",116,"Los Angeles Lakers",114,18997,0,-2,2,"2017-18",48.780487804878
"1760",2017-12-19,"Sacramento Kings",101,"Philadelphia 76ers",95,20558,0,-6,6,"2017-18",71.7391304347826
"1761",2017-12-19,"New Orleans Pelicans",106,"Washington Wizards",116,16529,1,10,10,"2017-18",56.8181818181818
"1762",2017-12-19,"Cleveland Cavaliers",116,"Milwaukee Bucks",119,18717,1,3,3,"2017-18",63.6363636363636
"1763",2017-12-20,"Toronto Raptors",129,"Charlotte Hornets",111,15023,0,-18,18,"2017-18",51.219512195122
"1764",2017-12-20,"Indiana Pacers",105,"Atlanta Hawks",95,14830,0,-10,10,"2017-18",39.0243902439024
"1765",2017-12-20,"Miami Heat",90,"Boston Celtics",89,18624,0,-1,1,"2017-18",71.1538461538462
"1766",2017-12-20,"Sacramento Kings",104,"Brooklyn Nets",99,13179,0,-5,5,"2017-18",36.5853658536585
"1767",2017-12-20,"Orlando Magic",94,"Chicago Bulls",112,20285,1,18,18,"2017-18",41.4634146341463
"1768",2017-12-20,"Los Angeles Lakers",122,"Houston Rockets",116,18055,0,-6,6,"2017-18",80.3921568627451
"1769",2017-12-20,"Utah Jazz",79,"Oklahoma City Thunder",107,18203,1,28,28,"2017-18",65.9090909090909
"1770",2017-12-20,"Detroit Pistons",93,"Dallas Mavericks",110,19580,1,17,17,"2017-18",36.5853658536585
"1771",2017-12-20,"Minnesota Timberwolves",112,"Denver Nuggets",104,17002,0,-8,8,"2017-18",75.609756097561
"1772",2017-12-20,"San Antonio Spurs",93,"Portland Trail Blazers",91,19393,0,-2,2,"2017-18",65.1162790697674
"1773",2017-12-20,"Memphis Grizzlies",84,"Golden State Warriors",97,19596,1,13,13,"2017-18",75
"1774",2017-12-20,"Phoenix Suns",95,"Los Angeles Clippers",108,17151,1,13,13,"2017-18",53.6585365853659
"1775",2017-12-21,"Chicago Bulls",112,"Cleveland Cavaliers",115,20562,1,3,3,"2017-18",71.1538461538462
"1776",2017-12-21,"Toronto Raptors",114,"Philadelphia 76ers",109,20680,0,-5,5,"2017-18",71.7391304347826
"1777",2017-12-21,"Boston Celtics",93,"New York Knicks",102,19812,1,9,9,"2017-18",46.3414634146341
"1778",2017-12-21,"Memphis Grizzlies",95,"Phoenix Suns",97,16339,1,2,2,"2017-18",24.390243902439
"1779",2017-12-21,"San Antonio Spurs",89,"Utah Jazz",100,18306,1,11,11,"2017-18",67.3913043478261
"1780",2017-12-22,"New York Knicks",101,"Detroit Pistons",104,16922,1,3,3,"2017-18",60.9756097560976
"1781",2017-12-22,"New Orleans Pelicans",111,"Orlando Magic",97,18846,0,-14,14,"2017-18",41.4634146341463
"1782",2017-12-22,"Washington Wizards",84,"Brooklyn Nets",119,15589,1,35,35,"2017-18",36.5853658536585
"1783",2017-12-22,"Los Angeles Clippers",128,"Houston Rockets",118,18055,0,-10,10,"2017-18",80.3921568627451
"1784",2017-12-22,"Dallas Mavericks",101,"Miami Heat",113,19600,1,12,12,"2017-18",60.4651162790698
"1785",2017-12-22,"Charlotte Hornets",104,"Milwaukee Bucks",109,17018,1,5,5,"2017-18",63.6363636363636
"1786",2017-12-22,"Atlanta Hawks",117,"Oklahoma City Thunder",120,18203,1,3,3,"2017-18",65.9090909090909
"1787",2017-12-22,"Denver Nuggets",102,"Portland Trail Blazers",85,19473,0,-17,17,"2017-18",65.1162790697674
"1788",2017-12-22,"Los Angeles Lakers",106,"Golden State Warriors",113,19596,1,7,7,"2017-18",75
"1789",2017-12-23,"Philadelphia 76ers",86,"Toronto Raptors",102,19800,1,16,16,"2017-18",80.4347826086957
"1790",2017-12-23,"Milwaukee Bucks",106,"Charlotte Hornets",111,18363,1,5,5,"2017-18",51.219512195122
"1791",2017-12-23,"Brooklyn Nets",119,"Indiana Pacers",123,17107,1,4,4,"2017-18",65.9090909090909
"1792",2017-12-23,"Orlando Magic",103,"Washington Wizards",130,17218,1,27,27,"2017-18",56.8181818181818
"1793",2017-12-23,"Dallas Mavericks",107,"Atlanta Hawks",112,13402,1,5,5,"2017-18",39.0243902439024
"1794",2017-12-23,"Chicago Bulls",92,"Boston Celtics",117,18624,1,25,25,"2017-18",71.1538461538462
"1795",2017-12-23,"Los Angeles Clippers",112,"Memphis Grizzlies",115,16844,1,3,3,"2017-18",39.0243902439024
"1796",2017-12-23,"New Orleans Pelicans",109,"Miami Heat",94,19600,0,-15,15,"2017-18",60.4651162790698
"1797",2017-12-23,"Oklahoma City Thunder",103,"Utah Jazz",89,18306,0,-14,14,"2017-18",67.3913043478261
"1798",2017-12-23,"Denver Nuggets",96,"Golden State Warriors",81,19596,0,-15,15,"2017-18",75
"1799",2017-12-23,"Minnesota Timberwolves",115,"Phoenix Suns",106,16482,0,-9,9,"2017-18",24.390243902439
"1800",2017-12-23,"Portland Trail Blazers",95,"Los Angeles Lakers",92,18997,0,-3,3,"2017-18",48.780487804878
"1801",2017-12-23,"San Antonio Spurs",108,"Sacramento Kings",99,17583,0,-9,9,"2017-18",34.1463414634146
"1802",2017-12-25,"Philadelphia 76ers",105,"New York Knicks",98,19812,0,-7,7,"2017-18",46.3414634146341
"1803",2017-12-25,"Cleveland Cavaliers",92,"Golden State Warriors",99,19596,1,7,7,"2017-18",75
"1804",2017-12-25,"Washington Wizards",111,"Boston Celtics",103,18624,0,-8,8,"2017-18",71.1538461538462
"1805",2017-12-25,"Houston Rockets",107,"Oklahoma City Thunder",112,18203,1,5,5,"2017-18",65.9090909090909
"1806",2017-12-25,"Minnesota Timberwolves",121,"Los Angeles Lakers",104,18997,0,-17,17,"2017-18",48.780487804878
"1807",2017-12-26,"Toronto Raptors",93,"Dallas Mavericks",98,20005,1,5,5,"2017-18",36.5853658536585
"1808",2017-12-26,"Indiana Pacers",83,"Detroit Pistons",107,20491,1,24,24,"2017-18",60.9756097560976
"1809",2017-12-26,"Orlando Magic",89,"Miami Heat",107,19600,1,18,18,"2017-18",60.4651162790698
"1810",2017-12-26,"Chicago Bulls",115,"Milwaukee Bucks",106,18717,0,-9,9,"2017-18",63.6363636363636
"1811",2017-12-26,"Brooklyn Nets",97,"San Antonio Spurs",109,18492,1,12,12,"2017-18",79.0697674418605
"1812",2017-12-26,"Utah Jazz",83,"Denver Nuggets",107,17104,1,24,24,"2017-18",75.609756097561
"1813",2017-12-26,"Memphis Grizzlies",97,"Phoenix Suns",99,17105,1,2,2,"2017-18",24.390243902439
"1814",2017-12-26,"Sacramento Kings",95,"Los Angeles Clippers",122,16393,1,27,27,"2017-18",53.6585365853659
"1815",2017-12-27,"Boston Celtics",102,"Charlotte Hornets",91,19611,0,-11,11,"2017-18",51.219512195122
"1816",2017-12-27,"Dallas Mavericks",98,"Indiana Pacers",94,17923,0,-4,4,"2017-18",65.9090909090909
"1817",2017-12-27,"Washington Wizards",99,"Atlanta Hawks",113,15763,1,14,14,"2017-18",39.0243902439024
"1818",2017-12-27,"New York Knicks",87,"Chicago Bulls",92,21883,1,5,5,"2017-18",41.4634146341463
"1819",2017-12-27,"Denver Nuggets",125,"Minnesota Timberwolves",128,18978,1,3,3,"2017-18",72.0930232558139
"1820",2017-12-27,"Brooklyn Nets",113,"New Orleans Pelicans",128,16707,1,15,15,"2017-18",60
"1821",2017-12-27,"Toronto Raptors",107,"Oklahoma City Thunder",124,18203,1,17,17,"2017-18",65.9090909090909
"1822",2017-12-27,"Cleveland Cavaliers",95,"Sacramento Kings",109,17583,1,14,14,"2017-18",34.1463414634146
"1823",2017-12-27,"Utah Jazz",101,"Golden State Warriors",126,19596,1,25,25,"2017-18",75
"1824",2017-12-27,"Memphis Grizzlies",109,"Los Angeles Lakers",99,18997,0,-10,10,"2017-18",48.780487804878
"1825",2017-12-28,"Detroit Pistons",89,"Orlando Magic",102,18846,1,13,13,"2017-18",41.4634146341463
"1826",2017-12-28,"Houston Rockets",98,"Boston Celtics",99,18624,1,1,1,"2017-18",71.1538461538462
"1827",2017-12-28,"Minnesota Timberwolves",96,"Milwaukee Bucks",102,18717,1,6,6,"2017-18",63.6363636363636
"1828",2017-12-28,"New York Knicks",107,"San Antonio Spurs",119,18935,1,12,12,"2017-18",79.0697674418605
"1829",2017-12-28,"Philadelphia 76ers",110,"Portland Trail Blazers",114,20104,1,4,4,"2017-18",65.1162790697674
"1830",2017-12-29,"Houston Rockets",103,"Washington Wizards",121,20356,1,18,18,"2017-18",56.8181818181818
"1831",2017-12-29,"Atlanta Hawks",98,"Toronto Raptors",111,19800,1,13,13,"2017-18",80.4347826086957
"1832",2017-12-29,"Indiana Pacers",107,"Chicago Bulls",119,21178,1,12,12,"2017-18",41.4634146341463
"1833",2017-12-29,"Brooklyn Nets",111,"Miami Heat",87,19600,0,-24,24,"2017-18",60.4651162790698
"1834",2017-12-29,"Dallas Mavericks",128,"New Orleans Pelicans",120,16878,0,-8,8,"2017-18",60
"1835",2017-12-29,"Milwaukee Bucks",97,"Oklahoma City Thunder",95,18203,0,-2,2,"2017-18",65.9090909090909
"1836",2017-12-29,"Phoenix Suns",111,"Sacramento Kings",101,17583,0,-10,10,"2017-18",34.1463414634146
"1837",2017-12-29,"Charlotte Hornets",111,"Golden State Warriors",100,19596,0,-11,11,"2017-18",75
"1838",2017-12-29,"Los Angeles Clippers",121,"Los Angeles Lakers",106,18997,0,-15,15,"2017-18",48.780487804878
"1839",2017-12-30,"San Antonio Spurs",79,"Detroit Pistons",93,19671,1,14,14,"2017-18",60.9756097560976
"1840",2017-12-30,"New York Knicks",105,"New Orleans Pelicans",103,16947,0,-2,2,"2017-18",60
"1841",2017-12-30,"Miami Heat",117,"Orlando Magic",111,18846,0,-6,6,"2017-18",41.4634146341463
"1842",2017-12-30,"Portland Trail Blazers",89,"Atlanta Hawks",104,15877,1,15,15,"2017-18",39.0243902439024
"1843",2017-12-30,"Cleveland Cavaliers",101,"Utah Jazz",104,18306,1,3,3,"2017-18",67.3913043478261
"1844",2017-12-30,"Memphis Grizzlies",128,"Golden State Warriors",141,19596,1,13,13,"2017-18",75
"1845",2017-12-30,"Philadelphia 76ers",107,"Denver Nuggets",102,19599,0,-5,5,"2017-18",75.609756097561
"1846",2017-12-31,"Chicago Bulls",110,"Washington Wizards",114,20356,1,4,4,"2017-18",56.8181818181818
"1847",2017-12-31,"Minnesota Timberwolves",107,"Indiana Pacers",90,17923,0,-17,17,"2017-18",65.9090909090909
"1848",2017-12-31,"Brooklyn Nets",105,"Boston Celtics",108,18624,1,3,3,"2017-18",71.1538461538462
"1849",2017-12-31,"Los Angeles Lakers",142,"Houston Rockets",148,18179,1,6,6,"2017-18",80.3921568627451
"1850",2017-12-31,"Charlotte Hornets",98,"Los Angeles Clippers",106,17348,1,8,8,"2017-18",53.6585365853659
"1851",2017-12-31,"Dallas Mavericks",116,"Oklahoma City Thunder",113,18203,0,-3,3,"2017-18",65.9090909090909
"1852",2017-12-31,"Memphis Grizzlies",114,"Sacramento Kings",96,17583,0,-18,18,"2017-18",34.1463414634146
"1853",2017-12-31,"Philadelphia 76ers",123,"Phoenix Suns",110,16983,0,-13,13,"2017-18",24.390243902439
"1854",2018-01-01,"Orlando Magic",95,"Brooklyn Nets",98,16164,1,3,3,"2017-18",36.5853658536585
"1855",2018-01-01,"Milwaukee Bucks",127,"Toronto Raptors",131,19800,1,4,4,"2017-18",80.4347826086957
"1856",2018-01-01,"Portland Trail Blazers",124,"Chicago Bulls",120,20860,0,-4,4,"2017-18",41.4634146341463
"1857",2018-01-01,"Los Angeles Lakers",96,"Minnesota Timberwolves",114,18978,1,18,18,"2017-18",72.0930232558139
"1858",2018-01-02,"Portland Trail Blazers",110,"Cleveland Cavaliers",127,20562,1,17,17,"2017-18",71.1538461538462
"1859",2018-01-02,"San Antonio Spurs",100,"New York Knicks",91,19812,0,-9,9,"2017-18",46.3414634146341
"1860",2018-01-02,"Atlanta Hawks",103,"Phoenix Suns",104,15921,1,1,1,"2017-18",24.390243902439
"1861",2018-01-02,"Charlotte Hornets",131,"Sacramento Kings",111,17583,0,-20,20,"2017-18",34.1463414634146
"1862",2018-01-02,"Memphis Grizzlies",105,"Los Angeles Clippers",113,15711,1,8,8,"2017-18",53.6585365853659
"1863",2018-01-03,"Houston Rockets",116,"Orlando Magic",98,18588,0,-18,18,"2017-18",41.4634146341463
"1864",2018-01-03,"San Antonio Spurs",106,"Philadelphia 76ers",112,20642,1,6,6,"2017-18",71.7391304347826
"1865",2018-01-03,"New York Knicks",103,"Washington Wizards",121,17206,1,18,18,"2017-18",56.8181818181818
"1866",2018-01-03,"Minnesota Timberwolves",97,"Brooklyn Nets",98,16215,1,1,1,"2017-18",36.5853658536585
"1867",2018-01-03,"Detroit Pistons",104,"Miami Heat",111,19600,1,7,7,"2017-18",60.4651162790698
"1868",2018-01-03,"Cleveland Cavaliers",88,"Boston Celtics",102,18624,1,14,14,"2017-18",71.1538461538462
"1869",2018-01-03,"Toronto Raptors",124,"Chicago Bulls",115,20056,0,-9,9,"2017-18",41.4634146341463
"1870",2018-01-03,"Indiana Pacers",101,"Milwaukee Bucks",122,15613,1,21,21,"2017-18",63.6363636363636
"1871",2018-01-03,"Golden State Warriors",125,"Dallas Mavericks",122,20212,0,-3,3,"2017-18",36.5853658536585
"1872",2018-01-03,"Phoenix Suns",111,"Denver Nuggets",134,14079,1,23,23,"2017-18",75.609756097561
"1873",2018-01-03,"New Orleans Pelicans",108,"Utah Jazz",98,18306,0,-10,10,"2017-18",67.3913043478261
"1874",2018-01-03,"Oklahoma City Thunder",133,"Los Angeles Lakers",96,18997,0,-37,37,"2017-18",48.780487804878
"1875",2018-01-04,"Golden State Warriors",124,"Houston Rockets",114,18055,0,-10,10,"2017-18",80.3921568627451
"1876",2018-01-04,"Oklahoma City Thunder",127,"Los Angeles Clippers",117,19068,0,-10,10,"2017-18",53.6585365853659
"1877",2018-01-05,"Minnesota Timberwolves",84,"Boston Celtics",91,18624,1,7,7,"2017-18",71.1538461538462
"1878",2018-01-05,"Detroit Pistons",78,"Philadelphia 76ers",114,20592,1,36,36,"2017-18",71.7391304347826
"1879",2018-01-05,"New York Knicks",103,"Miami Heat",107,19600,1,4,4,"2017-18",60.4651162790698
"1880",2018-01-05,"Toronto Raptors",129,"Milwaukee Bucks",110,18717,0,-19,19,"2017-18",63.6363636363636
"1881",2018-01-05,"Chicago Bulls",127,"Dallas Mavericks",124,20073,0,-3,3,"2017-18",36.5853658536585
"1882",2018-01-05,"Phoenix Suns",89,"San Antonio Spurs",103,18501,1,14,14,"2017-18",79.0697674418605
"1883",2018-01-05,"Utah Jazz",91,"Denver Nuggets",99,15557,1,8,8,"2017-18",75.609756097561
"1884",2018-01-05,"Washington Wizards",102,"Memphis Grizzlies",100,16988,0,-2,2,"2017-18",39.0243902439024
"1885",2018-01-05,"Atlanta Hawks",89,"Portland Trail Blazers",110,19393,1,21,21,"2017-18",65.1162790697674
"1886",2018-01-05,"Charlotte Hornets",108,"Los Angeles Lakers",94,18997,0,-14,14,"2017-18",48.780487804878
"1887",2018-01-06,"Golden State Warriors",121,"Los Angeles Clippers",105,19068,0,-16,16,"2017-18",53.6585365853659
"1888",2018-01-06,"Boston Celtics",87,"Brooklyn Nets",85,17732,0,-2,2,"2017-18",36.5853658536585
"1889",2018-01-06,"Houston Rockets",101,"Detroit Pistons",108,18046,1,7,7,"2017-18",60.9756097560976
"1890",2018-01-06,"Chicago Bulls",86,"Indiana Pacers",125,17923,1,39,39,"2017-18",65.9090909090909
"1891",2018-01-06,"Cleveland Cavaliers",131,"Orlando Magic",127,18997,0,-4,4,"2017-18",41.4634146341463
"1892",2018-01-06,"Milwaukee Bucks",110,"Washington Wizards",103,18762,0,-7,7,"2017-18",56.8181818181818
"1893",2018-01-06,"New Orleans Pelicans",98,"Minnesota Timberwolves",116,18978,1,18,18,"2017-18",72.0930232558139
"1894",2018-01-06,"Denver Nuggets",98,"Sacramento Kings",106,17583,1,8,8,"2017-18",34.1463414634146
"1895",2018-01-07,"Utah Jazz",102,"Miami Heat",103,19600,1,1,1,"2017-18",60.4651162790698
"1896",2018-01-07,"New York Knicks",100,"Dallas Mavericks",96,20171,0,-4,4,"2017-18",36.5853658536585
"1897",2018-01-07,"Oklahoma City Thunder",100,"Phoenix Suns",114,18055,1,14,14,"2017-18",24.390243902439
"1898",2018-01-07,"San Antonio Spurs",110,"Portland Trail Blazers",111,19393,1,1,1,"2017-18",65.1162790697674
"1899",2018-01-07,"Atlanta Hawks",113,"Los Angeles Lakers",132,18997,1,19,19,"2017-18",48.780487804878
"1900",2018-01-08,"Milwaukee Bucks",96,"Indiana Pacers",109,14670,1,13,13,"2017-18",65.9090909090909
"1901",2018-01-08,"Toronto Raptors",114,"Brooklyn Nets",113,13681,0,-1,1,"2017-18",36.5853658536585
"1902",2018-01-08,"Houston Rockets",116,"Chicago Bulls",107,17462,0,-9,9,"2017-18",41.4634146341463
"1903",2018-01-08,"Cleveland Cavaliers",99,"Minnesota Timberwolves",127,18978,1,28,28,"2017-18",72.0930232558139
"1904",2018-01-08,"Detroit Pistons",109,"New Orleans Pelicans",112,12874,1,3,3,"2017-18",60
"1905",2018-01-08,"San Antonio Spurs",107,"Sacramento Kings",100,17583,0,-7,7,"2017-18",34.1463414634146
"1906",2018-01-08,"Denver Nuggets",114,"Golden State Warriors",124,19596,1,10,10,"2017-18",75
"1907",2018-01-08,"Atlanta Hawks",107,"Los Angeles Clippers",108,14624,1,1,1,"2017-18",53.6585365853659
"1908",2018-01-09,"Miami Heat",90,"Toronto Raptors",89,19800,0,-1,1,"2017-18",80.4347826086957
"1909",2018-01-09,"Portland Trail Blazers",117,"Oklahoma City Thunder",106,18203,0,-11,11,"2017-18",65.9090909090909
"1910",2018-01-09,"Orlando Magic",99,"Dallas Mavericks",114,19306,1,15,15,"2017-18",36.5853658536585
"1911",2018-01-09,"Sacramento Kings",86,"Los Angeles Lakers",99,18997,1,13,13,"2017-18",48.780487804878
"1912",2018-01-10,"Dallas Mavericks",115,"Charlotte Hornets",111,14462,0,-4,4,"2017-18",51.219512195122
"1913",2018-01-10,"Miami Heat",114,"Indiana Pacers",106,14540,0,-8,8,"2017-18",65.9090909090909
"1914",2018-01-10,"Utah Jazz",107,"Washington Wizards",104,15640,0,-3,3,"2017-18",56.8181818181818
"1915",2018-01-10,"Detroit Pistons",114,"Brooklyn Nets",80,13457,0,-34,34,"2017-18",36.5853658536585
"1916",2018-01-10,"Chicago Bulls",122,"New York Knicks",119,19812,0,-3,3,"2017-18",46.3414634146341
"1917",2018-01-10,"Portland Trail Blazers",112,"Houston Rockets",121,18055,1,9,9,"2017-18",80.3921568627451
"1918",2018-01-10,"New Orleans Pelicans",102,"Memphis Grizzlies",105,14312,1,3,3,"2017-18",39.0243902439024
"1919",2018-01-10,"Orlando Magic",103,"Milwaukee Bucks",110,14543,1,7,7,"2017-18",63.6363636363636
"1920",2018-01-10,"Oklahoma City Thunder",88,"Minnesota Timberwolves",104,18978,1,16,16,"2017-18",72.0930232558139
"1921",2018-01-10,"Atlanta Hawks",110,"Denver Nuggets",97,14182,0,-13,13,"2017-18",75.609756097561
"1922",2018-01-10,"Los Angeles Clippers",125,"Golden State Warriors",106,19596,0,-19,19,"2017-18",75
"1923",2018-01-11,"Boston Celtics",114,"Philadelphia 76ers",103,19078,0,-11,11,"2017-18",71.7391304347826
"1924",2018-01-11,"Cleveland Cavaliers",99,"Toronto Raptors",133,19923,1,34,34,"2017-18",80.4347826086957
"1925",2018-01-11,"Los Angeles Clippers",121,"Sacramento Kings",115,17583,0,-6,6,"2017-18",34.1463414634146
"1926",2018-01-11,"San Antonio Spurs",81,"Los Angeles Lakers",93,18997,1,12,12,"2017-18",48.780487804878
"1927",2018-01-12,"Utah Jazz",88,"Charlotte Hornets",99,14848,1,11,11,"2017-18",51.219512195122
"1928",2018-01-12,"Cleveland Cavaliers",95,"Indiana Pacers",97,17923,1,2,2,"2017-18",65.9090909090909
"1929",2018-01-12,"Orlando Magic",119,"Washington Wizards",125,18171,1,6,6,"2017-18",56.8181818181818
"1930",2018-01-12,"Brooklyn Nets",110,"Atlanta Hawks",105,13093,0,-5,5,"2017-18",39.0243902439024
"1931",2018-01-12,"Golden State Warriors",108,"Milwaukee Bucks",94,18717,0,-14,14,"2017-18",63.6363636363636
"1932",2018-01-12,"New York Knicks",108,"Minnesota Timberwolves",118,18978,1,10,10,"2017-18",72.0930232558139
"1933",2018-01-12,"Portland Trail Blazers",113,"New Orleans Pelicans",119,17003,1,6,6,"2017-18",60
"1934",2018-01-12,"Memphis Grizzlies",78,"Denver Nuggets",87,15607,1,9,9,"2017-18",75.609756097561
"1935",2018-01-12,"Houston Rockets",112,"Phoenix Suns",95,18055,0,-17,17,"2017-18",24.390243902439
"1936",2018-01-13,"Los Angeles Lakers",107,"Dallas Mavericks",101,20209,0,-6,6,"2017-18",36.5853658536585
"1937",2018-01-13,"Sacramento Kings",105,"Los Angeles Clippers",126,16656,1,21,21,"2017-18",53.6585365853659
"1938",2018-01-13,"Oklahoma City Thunder",101,"Charlotte Hornets",91,19624,0,-10,10,"2017-18",51.219512195122
"1939",2018-01-13,"Brooklyn Nets",113,"Washington Wizards",119,18354,1,6,6,"2017-18",56.8181818181818
"1940",2018-01-13,"Golden State Warriors",127,"Toronto Raptors",125,20078,0,-2,2,"2017-18",80.4347826086957
"1941",2018-01-13,"Detroit Pistons",105,"Chicago Bulls",107,21613,1,2,2,"2017-18",41.4634146341463
"1942",2018-01-13,"Denver Nuggets",80,"San Antonio Spurs",112,18418,1,32,32,"2017-18",79.0697674418605
"1943",2018-01-14,"Milwaukee Bucks",79,"Miami Heat",97,19600,1,18,18,"2017-18",60.4651162790698
"1944",2018-01-14,"New Orleans Pelicans",123,"New York Knicks",118,19812,0,-5,5,"2017-18",46.3414634146341
"1945",2018-01-14,"Indiana Pacers",120,"Phoenix Suns",97,17091,0,-23,23,"2017-18",24.390243902439
"1946",2018-01-14,"Portland Trail Blazers",103,"Minnesota Timberwolves",120,14739,1,17,17,"2017-18",72.0930232558139
"1947",2018-01-15,"Charlotte Hornets",118,"Detroit Pistons",107,17200,0,-11,11,"2017-18",60.9756097560976
"1948",2018-01-15,"Toronto Raptors",111,"Philadelphia 76ers",117,20637,1,6,6,"2017-18",71.7391304347826
"1949",2018-01-15,"Milwaukee Bucks",104,"Washington Wizards",95,19607,0,-9,9,"2017-18",56.8181818181818
"1950",2018-01-15,"San Antonio Spurs",99,"Atlanta Hawks",102,15806,1,3,3,"2017-18",39.0243902439024
"1951",2018-01-15,"New York Knicks",119,"Brooklyn Nets",104,17732,0,-15,15,"2017-18",36.5853658536585
"1952",2018-01-15,"Miami Heat",111,"Chicago Bulls",119,20546,1,8,8,"2017-18",41.4634146341463
"1953",2018-01-15,"Los Angeles Lakers",114,"Memphis Grizzlies",123,17794,1,9,9,"2017-18",39.0243902439024
"1954",2018-01-15,"Golden State Warriors",118,"Cleveland Cavaliers",108,20562,0,-10,10,"2017-18",71.1538461538462
"1955",2018-01-15,"Sacramento Kings",88,"Oklahoma City Thunder",95,18203,1,7,7,"2017-18",65.9090909090909
"1956",2018-01-15,"Indiana Pacers",109,"Utah Jazz",94,18306,0,-15,15,"2017-18",67.3913043478261
"1957",2018-01-15,"Houston Rockets",102,"Los Angeles Clippers",113,17622,1,11,11,"2017-18",53.6585365853659
"1958",2018-01-16,"Minnesota Timberwolves",102,"Orlando Magic",108,18589,1,6,6,"2017-18",41.4634146341463
"1959",2018-01-16,"New Orleans Pelicans",116,"Boston Celtics",113,18624,0,-3,3,"2017-18",71.1538461538462
"1960",2018-01-16,"Dallas Mavericks",102,"Denver Nuggets",105,14097,1,3,3,"2017-18",75.609756097561
"1961",2018-01-16,"Phoenix Suns",111,"Portland Trail Blazers",118,18604,1,7,7,"2017-18",65.1162790697674
"1962",2018-01-17,"Washington Wizards",109,"Charlotte Hornets",133,11528,1,24,24,"2017-18",51.219512195122
"1963",2018-01-17,"New Orleans Pelicans",93,"Atlanta Hawks",94,10894,1,1,1,"2017-18",39.0243902439024
"1964",2018-01-17,"San Antonio Spurs",100,"Brooklyn Nets",95,15425,0,-5,5,"2017-18",36.5853658536585
"1965",2018-01-17,"Detroit Pistons",91,"Toronto Raptors",96,19800,1,5,5,"2017-18",80.4347826086957
"1966",2018-01-17,"Golden State Warriors",119,"Chicago Bulls",112,21372,0,-7,7,"2017-18",41.4634146341463
"1967",2018-01-17,"New York Knicks",99,"Memphis Grizzlies",105,12885,1,6,6,"2017-18",39.0243902439024
"1968",2018-01-17,"Miami Heat",106,"Milwaukee Bucks",101,16695,0,-5,5,"2017-18",63.6363636363636
"1969",2018-01-17,"Los Angeles Lakers",90,"Oklahoma City Thunder",114,18203,1,24,24,"2017-18",65.9090909090909
"1970",2018-01-17,"Utah Jazz",120,"Sacramento Kings",105,17583,0,-15,15,"2017-18",34.1463414634146
"1971",2018-01-17,"Denver Nuggets",104,"Los Angeles Clippers",109,15043,1,5,5,"2017-18",53.6585365853659
"1972",2018-01-18,"Philadelphia 76ers",89,"Boston Celtics",80,18624,0,-9,9,"2017-18",71.1538461538462
"1973",2018-01-18,"Orlando Magic",103,"Cleveland Cavaliers",104,20562,1,1,1,"2017-18",71.1538461538462
"1974",2018-01-18,"Minnesota Timberwolves",98,"Houston Rockets",116,18055,1,18,18,"2017-18",80.3921568627451
"1975",2018-01-18,"Indiana Pacers",86,"Portland Trail Blazers",100,19071,1,14,14,"2017-18",65.1162790697674
"1976",2018-01-19,"San Antonio Spurs",83,"Toronto Raptors",86,19800,1,3,3,"2017-18",80.4347826086957
"1977",2018-01-19,"Miami Heat",95,"Brooklyn Nets",101,17732,1,6,6,"2017-18",36.5853658536585
"1978",2018-01-19,"Washington Wizards",122,"Detroit Pistons",112,14744,0,-10,10,"2017-18",60.9756097560976
"1979",2018-01-19,"Sacramento Kings",88,"Memphis Grizzlies",106,16831,1,18,18,"2017-18",39.0243902439024
"1980",2018-01-19,"Phoenix Suns",108,"Denver Nuggets",100,15732,0,-8,8,"2017-18",75.609756097561
"1981",2018-01-19,"Indiana Pacers",86,"Los Angeles Lakers",99,18997,1,13,13,"2017-18",48.780487804878
"1982",2018-01-19,"New York Knicks",117,"Utah Jazz",115,18306,0,-2,2,"2017-18",67.3913043478261
"1983",2018-01-20,"Oklahoma City Thunder",148,"Cleveland Cavaliers",124,20562,0,-24,24,"2017-18",71.1538461538462
"1984",2018-01-20,"Chicago Bulls",113,"Atlanta Hawks",97,15597,0,-16,16,"2017-18",39.0243902439024
"1985",2018-01-20,"Miami Heat",106,"Charlotte Hornets",105,18687,0,-1,1,"2017-18",51.219512195122
"1986",2018-01-20,"Memphis Grizzlies",104,"New Orleans Pelicans",111,18212,1,7,7,"2017-18",60
"1987",2018-01-20,"Milwaukee Bucks",94,"Philadelphia 76ers",116,20826,1,22,22,"2017-18",71.7391304347826
"1988",2018-01-20,"Golden State Warriors",108,"Houston Rockets",116,18055,1,8,8,"2017-18",80.3921568627451
"1989",2018-01-20,"Toronto Raptors",109,"Minnesota Timberwolves",115,17828,1,6,6,"2017-18",72.0930232558139
"1990",2018-01-20,"Los Angeles Clippers",113,"Utah Jazz",125,18306,1,12,12,"2017-18",67.3913043478261
"1991",2018-01-20,"Dallas Mavericks",108,"Portland Trail Blazers",117,19464,1,9,9,"2017-18",65.1162790697674
"1992",2018-01-21,"Orlando Magic",103,"Boston Celtics",95,18624,0,-8,8,"2017-18",71.1538461538462
"1993",2018-01-21,"New York Knicks",107,"Los Angeles Lakers",127,18997,1,20,20,"2017-18",48.780487804878
"1994",2018-01-21,"Brooklyn Nets",101,"Detroit Pistons",100,17554,0,-1,1,"2017-18",60.9756097560976
"1995",2018-01-21,"Indiana Pacers",94,"San Antonio Spurs",86,18418,0,-8,8,"2017-18",79.0697674418605
"1996",2018-01-22,"Sacramento Kings",107,"Charlotte Hornets",112,11806,1,5,5,"2017-18",51.219512195122
"1997",2018-01-22,"Utah Jazz",90,"Atlanta Hawks",104,11096,1,14,14,"2017-18",39.0243902439024
"1998",2018-01-22,"Miami Heat",90,"Houston Rockets",99,18055,1,9,9,"2017-18",80.3921568627451
"1999",2018-01-22,"Philadelphia 76ers",101,"Memphis Grizzlies",105,14288,1,4,4,"2017-18",39.0243902439024
"2000",2018-01-22,"Phoenix Suns",105,"Milwaukee Bucks",109,14766,1,4,4,"2017-18",63.6363636363636
"2001",2018-01-22,"Chicago Bulls",128,"New Orleans Pelicans",132,17101,1,4,4,"2017-18",60
"2002",2018-01-22,"Washington Wizards",75,"Dallas Mavericks",98,19328,1,23,23,"2017-18",36.5853658536585
"2003",2018-01-22,"Portland Trail Blazers",101,"Denver Nuggets",104,14474,1,3,3,"2017-18",75.609756097561
"2004",2018-01-22,"Minnesota Timberwolves",126,"Los Angeles Clippers",118,16347,0,-8,8,"2017-18",53.6585365853659
"2005",2018-01-23,"Sacramento Kings",105,"Orlando Magic",99,18846,0,-6,6,"2017-18",41.4634146341463
"2006",2018-01-23,"Brooklyn Nets",108,"Oklahoma City Thunder",109,18203,1,1,1,"2017-18",65.9090909090909
"2007",2018-01-23,"Cleveland Cavaliers",102,"San Antonio Spurs",114,18418,1,12,12,"2017-18",79.0697674418605
"2008",2018-01-23,"New York Knicks",112,"Golden State Warriors",123,19596,1,11,11,"2017-18",75
"2009",2018-01-23,"Boston Celtics",107,"Los Angeles Lakers",108,18997,1,1,1,"2017-18",48.780487804878
"2010",2018-01-24,"New Orleans Pelicans",101,"Charlotte Hornets",96,14588,0,-5,5,"2017-18",51.219512195122
"2011",2018-01-24,"Utah Jazz",98,"Detroit Pistons",95,15682,0,-3,3,"2017-18",60.9756097560976
"2012",2018-01-24,"Phoenix Suns",101,"Indiana Pacers",116,14060,1,15,15,"2017-18",65.9090909090909
"2013",2018-01-24,"Chicago Bulls",101,"Philadelphia 76ers",115,20547,1,14,14,"2017-18",71.7391304347826
"2014",2018-01-24,"Toronto Raptors",108,"Atlanta Hawks",93,12780,0,-15,15,"2017-18",39.0243902439024
"2015",2018-01-24,"Houston Rockets",104,"Dallas Mavericks",97,19378,0,-7,7,"2017-18",36.5853658536585
"2016",2018-01-24,"San Antonio Spurs",108,"Memphis Grizzlies",85,15812,0,-23,23,"2017-18",39.0243902439024
"2017",2018-01-24,"Minnesota Timberwolves",114,"Portland Trail Blazers",123,18920,1,9,9,"2017-18",65.1162790697674
"2018",2018-01-24,"Boston Celtics",113,"Los Angeles Clippers",102,19430,0,-11,11,"2017-18",53.6585365853659
"2019",2018-01-25,"Sacramento Kings",89,"Miami Heat",88,19600,0,-1,1,"2017-18",60.4651162790698
"2020",2018-01-25,"Washington Wizards",112,"Oklahoma City Thunder",121,18203,1,9,9,"2017-18",65.9090909090909
"2021",2018-01-25,"New York Knicks",118,"Denver Nuggets",130,15482,1,12,12,"2017-18",75.609756097561
"2022",2018-01-25,"Minnesota Timberwolves",113,"Golden State Warriors",126,19596,1,13,13,"2017-18",75
"2023",2018-01-26,"Atlanta Hawks",110,"Charlotte Hornets",121,15479,1,11,11,"2017-18",51.219512195122
"2024",2018-01-26,"Indiana Pacers",108,"Cleveland Cavaliers",115,20562,1,7,7,"2017-18",71.1538461538462
"2025",2018-01-26,"Utah Jazz",97,"Toronto Raptors",93,19800,0,-4,4,"2017-18",80.4347826086957
"2026",2018-01-26,"Los Angeles Lakers",108,"Chicago Bulls",103,21827,0,-5,5,"2017-18",41.4634146341463
"2027",2018-01-26,"Los Angeles Clippers",109,"Memphis Grizzlies",100,16369,0,-9,9,"2017-18",39.0243902439024
"2028",2018-01-26,"Brooklyn Nets",91,"Milwaukee Bucks",116,18717,1,25,25,"2017-18",63.6363636363636
"2029",2018-01-26,"Houston Rockets",113,"New Orleans Pelicans",115,17186,1,2,2,"2017-18",60
"2030",2018-01-26,"Portland Trail Blazers",107,"Dallas Mavericks",93,19876,0,-14,14,"2017-18",36.5853658536585
"2031",2018-01-26,"Philadelphia 76ers",97,"San Antonio Spurs",78,18418,0,-19,19,"2017-18",79.0697674418605
"2032",2018-01-26,"New York Knicks",107,"Phoenix Suns",85,17068,0,-22,22,"2017-18",24.390243902439
"2033",2018-01-27,"Oklahoma City Thunder",121,"Detroit Pistons",108,20491,0,-13,13,"2017-18",60.9756097560976
"2034",2018-01-27,"Orlando Magic",112,"Indiana Pacers",114,17923,1,2,2,"2017-18",65.9090909090909
"2035",2018-01-27,"Washington Wizards",129,"Atlanta Hawks",104,15843,0,-25,25,"2017-18",39.0243902439024
"2036",2018-01-27,"Charlotte Hornets",91,"Miami Heat",95,19600,1,4,4,"2017-18",60.4651162790698
"2037",2018-01-27,"Boston Celtics",105,"Golden State Warriors",109,19596,1,4,4,"2017-18",75
"2038",2018-01-27,"Dallas Mavericks",89,"Denver Nuggets",91,19520,1,2,2,"2017-18",75.609756097561
"2039",2018-01-27,"Brooklyn Nets",97,"Minnesota Timberwolves",111,16231,1,14,14,"2017-18",72.0930232558139
"2040",2018-01-28,"Milwaukee Bucks",110,"Chicago Bulls",96,21630,0,-14,14,"2017-18",41.4634146341463
"2041",2018-01-28,"Phoenix Suns",102,"Houston Rockets",113,18055,1,11,11,"2017-18",80.3921568627451
"2042",2018-01-28,"Los Angeles Clippers",112,"New Orleans Pelicans",103,16378,0,-9,9,"2017-18",60
"2043",2018-01-28,"Detroit Pistons",104,"Cleveland Cavaliers",121,20562,1,17,17,"2017-18",71.1538461538462
"2044",2018-01-28,"Philadelphia 76ers",112,"Oklahoma City Thunder",122,18202,1,10,10,"2017-18",65.9090909090909
"2045",2018-01-28,"Los Angeles Lakers",111,"Toronto Raptors",123,19800,1,12,12,"2017-18",80.4347826086957
"2046",2018-01-28,"Sacramento Kings",98,"San Antonio Spurs",113,18418,1,15,15,"2017-18",79.0697674418605
"2047",2018-01-29,"Charlotte Hornets",96,"Indiana Pacers",105,14225,1,9,9,"2017-18",65.9090909090909
"2048",2018-01-29,"Minnesota Timberwolves",100,"Atlanta Hawks",105,12589,1,5,5,"2017-18",39.0243902439024
"2049",2018-01-29,"Phoenix Suns",109,"Memphis Grizzlies",120,13202,1,11,11,"2017-18",39.0243902439024
"2050",2018-01-29,"Philadelphia 76ers",95,"Milwaukee Bucks",107,14126,1,12,12,"2017-18",63.6363636363636
"2051",2018-01-29,"Miami Heat",95,"Dallas Mavericks",88,19555,0,-7,7,"2017-18",36.5853658536585
"2052",2018-01-29,"Boston Celtics",111,"Denver Nuggets",110,19520,0,-1,1,"2017-18",75.609756097561
"2053",2018-01-30,"Oklahoma City Thunder",96,"Washington Wizards",102,20356,1,6,6,"2017-18",56.8181818181818
"2054",2018-01-30,"Brooklyn Nets",95,"New York Knicks",111,19505,1,16,16,"2017-18",46.3414634146341
"2055",2018-01-30,"Minnesota Timberwolves",104,"Toronto Raptors",109,19800,1,5,5,"2017-18",80.4347826086957
"2056",2018-01-30,"Cleveland Cavaliers",114,"Detroit Pistons",125,18508,1,11,11,"2017-18",60.9756097560976
"2057",2018-01-30,"Orlando Magic",107,"Houston Rockets",114,18055,1,7,7,"2017-18",80.3921568627451
"2058",2018-01-30,"Sacramento Kings",114,"New Orleans Pelicans",103,14292,0,-11,11,"2017-18",60
"2059",2018-01-30,"Denver Nuggets",104,"San Antonio Spurs",106,18418,1,2,2,"2017-18",79.0697674418605
"2060",2018-01-30,"Golden State Warriors",99,"Utah Jazz",129,18306,1,30,30,"2017-18",67.3913043478261
"2061",2018-01-30,"Portland Trail Blazers",104,"Los Angeles Clippers",96,16705,0,-8,8,"2017-18",53.6585365853659
"2062",2018-01-31,"Memphis Grizzlies",101,"Indiana Pacers",105,15093,1,4,4,"2017-18",65.9090909090909
"2063",2018-01-31,"Los Angeles Lakers",105,"Orlando Magic",127,18553,1,22,22,"2017-18",41.4634146341463
"2064",2018-01-31,"Charlotte Hornets",123,"Atlanta Hawks",110,13103,0,-13,13,"2017-18",39.0243902439024
"2065",2018-01-31,"Philadelphia 76ers",108,"Brooklyn Nets",116,15577,1,8,8,"2017-18",36.5853658536585
"2066",2018-01-31,"Miami Heat",89,"Cleveland Cavaliers",91,20562,1,2,2,"2017-18",71.1538461538462
"2067",2018-01-31,"New York Knicks",73,"Boston Celtics",103,18624,1,30,30,"2017-18",71.1538461538462
"2068",2018-01-31,"Chicago Bulls",108,"Portland Trail Blazers",124,19422,1,16,16,"2017-18",65.1162790697674
"2069",2018-01-31,"Dallas Mavericks",88,"Phoenix Suns",102,15923,1,14,14,"2017-18",24.390243902439
"2070",2018-02-01,"Memphis Grizzlies",102,"Detroit Pistons",104,17481,1,2,2,"2017-18",60.9756097560976
"2071",2018-02-01,"Toronto Raptors",119,"Washington Wizards",122,15599,1,3,3,"2017-18",56.8181818181818
"2072",2018-02-01,"Milwaukee Bucks",89,"Minnesota Timberwolves",108,17199,1,19,19,"2017-18",72.0930232558139
"2073",2018-02-01,"Houston Rockets",102,"San Antonio Spurs",91,18418,0,-11,11,"2017-18",79.0697674418605
"2074",2018-02-01,"Oklahoma City Thunder",124,"Denver Nuggets",127,18407,1,3,3,"2017-18",75.609756097561
"2075",2018-02-02,"Indiana Pacers",126,"Charlotte Hornets",133,17135,1,7,7,"2017-18",51.219512195122
"2076",2018-02-02,"Atlanta Hawks",110,"Boston Celtics",119,18624,1,9,9,"2017-18",71.1538461538462
"2077",2018-02-02,"Los Angeles Lakers",102,"Brooklyn Nets",99,17732,0,-3,3,"2017-18",36.5853658536585
"2078",2018-02-02,"Portland Trail Blazers",105,"Toronto Raptors",130,19800,1,25,25,"2017-18",80.4347826086957
"2079",2018-02-02,"New York Knicks",90,"Milwaukee Bucks",92,18717,1,2,2,"2017-18",63.6363636363636
"2080",2018-02-02,"Miami Heat",97,"Philadelphia 76ers",103,20636,1,6,6,"2017-18",71.7391304347826
"2081",2018-02-02,"New Orleans Pelicans",114,"Oklahoma City Thunder",100,18203,0,-14,14,"2017-18",65.9090909090909
"2082",2018-02-02,"Utah Jazz",129,"Phoenix Suns",97,16560,0,-32,32,"2017-18",24.390243902439
"2083",2018-02-02,"Golden State Warriors",119,"Sacramento Kings",104,17583,0,-15,15,"2017-18",34.1463414634146
"2084",2018-02-03,"Chicago Bulls",103,"Los Angeles Clippers",113,19068,1,10,10,"2017-18",53.6585365853659
"2085",2018-02-03,"Miami Heat",107,"Detroit Pistons",111,18747,1,4,4,"2017-18",60.9756097560976
"2086",2018-02-03,"Philadelphia 76ers",92,"Indiana Pacers",100,17923,1,8,8,"2017-18",65.9090909090909
"2087",2018-02-03,"Washington Wizards",115,"Orlando Magic",98,18846,0,-17,17,"2017-18",41.4634146341463
"2088",2018-02-03,"Houston Rockets",120,"Cleveland Cavaliers",88,20562,0,-32,32,"2017-18",71.1538461538462
"2089",2018-02-03,"Golden State Warriors",108,"Denver Nuggets",115,20103,1,7,7,"2017-18",75.609756097561
"2090",2018-02-03,"New Orleans Pelicans",107,"Minnesota Timberwolves",118,17954,1,11,11,"2017-18",72.0930232558139
"2091",2018-02-03,"Utah Jazz",120,"San Antonio Spurs",111,18418,0,-9,9,"2017-18",79.0697674418605
"2092",2018-02-03,"Dallas Mavericks",106,"Sacramento Kings",99,17583,0,-7,7,"2017-18",34.1463414634146
"2093",2018-02-04,"Portland Trail Blazers",96,"Boston Celtics",97,18624,1,1,1,"2017-18",71.1538461538462
"2094",2018-02-04,"Milwaukee Bucks",109,"Brooklyn Nets",94,14392,0,-15,15,"2017-18",36.5853658536585
"2095",2018-02-04,"Atlanta Hawks",99,"New York Knicks",96,19441,0,-3,3,"2017-18",46.3414634146341
"2096",2018-02-04,"Memphis Grizzlies",86,"Toronto Raptors",101,19800,1,15,15,"2017-18",80.4347826086957
"2097",2018-02-04,"Los Angeles Lakers",108,"Oklahoma City Thunder",104,18203,0,-4,4,"2017-18",65.9090909090909
"2098",2018-02-04,"Charlotte Hornets",115,"Phoenix Suns",110,14487,0,-5,5,"2017-18",24.390243902439
"2099",2018-02-05,"Portland Trail Blazers",91,"Detroit Pistons",111,13810,1,20,20,"2017-18",60.9756097560976
"2100",2018-02-05,"Washington Wizards",111,"Indiana Pacers",102,13169,0,-9,9,"2017-18",65.9090909090909
"2101",2018-02-05,"Orlando Magic",111,"Miami Heat",109,19600,0,-2,2,"2017-18",60.4651162790698
"2102",2018-02-05,"Utah Jazz",133,"New Orleans Pelicans",109,14293,0,-24,24,"2017-18",60
"2103",2018-02-05,"Charlotte Hornets",104,"Denver Nuggets",121,14410,1,17,17,"2017-18",75.609756097561
"2104",2018-02-05,"Chicago Bulls",98,"Sacramento Kings",104,17583,1,6,6,"2017-18",34.1463414634146
"2105",2018-02-05,"Dallas Mavericks",101,"Los Angeles Clippers",104,15127,1,3,3,"2017-18",53.6585365853659
"2106",2018-02-06,"Cleveland Cavaliers",98,"Orlando Magic",116,18846,1,18,18,"2017-18",41.4634146341463
"2107",2018-02-06,"Memphis Grizzlies",82,"Atlanta Hawks",108,11866,1,26,26,"2017-18",39.0243902439024
"2108",2018-02-06,"Houston Rockets",123,"Brooklyn Nets",113,15064,0,-10,10,"2017-18",36.5853658536585
"2109",2018-02-06,"Milwaukee Bucks",103,"New York Knicks",89,19812,0,-14,14,"2017-18",46.3414634146341
"2110",2018-02-06,"Boston Celtics",91,"Toronto Raptors",111,20017,1,20,20,"2017-18",80.4347826086957
"2111",2018-02-06,"Washington Wizards",102,"Philadelphia 76ers",115,20530,1,13,13,"2017-18",71.7391304347826
"2112",2018-02-06,"Oklahoma City Thunder",125,"Golden State Warriors",105,19596,0,-20,20,"2017-18",75
"2113",2018-02-06,"Phoenix Suns",93,"Los Angeles Lakers",112,18997,1,19,19,"2017-18",48.780487804878
"2114",2018-02-07,"Brooklyn Nets",106,"Detroit Pistons",115,15114,1,9,9,"2017-18",60.9756097560976
"2115",2018-02-07,"Houston Rockets",109,"Miami Heat",101,19600,0,-8,8,"2017-18",60.4651162790698
"2116",2018-02-07,"Minnesota Timberwolves",138,"Cleveland Cavaliers",140,20562,1,2,2,"2017-18",71.1538461538462
"2117",2018-02-07,"Utah Jazz",92,"Memphis Grizzlies",88,13187,0,-4,4,"2017-18",39.0243902439024
"2118",2018-02-07,"San Antonio Spurs",129,"Phoenix Suns",81,15993,0,-48,48,"2017-18",24.390243902439
"2119",2018-02-08,"Atlanta Hawks",98,"Orlando Magic",100,16215,1,2,2,"2017-18",41.4634146341463
"2120",2018-02-08,"New York Knicks",88,"Toronto Raptors",113,19800,1,25,25,"2017-18",80.4347826086957
"2121",2018-02-08,"Boston Celtics",110,"Washington Wizards",104,20356,0,-6,6,"2017-18",56.8181818181818
"2122",2018-02-08,"Charlotte Hornets",103,"Portland Trail Blazers",109,19178,1,6,6,"2017-18",65.1162790697674
"2123",2018-02-08,"Dallas Mavericks",103,"Golden State Warriors",121,19596,1,18,18,"2017-18",75
"2124",2018-02-08,"Oklahoma City Thunder",81,"Los Angeles Lakers",106,18997,1,25,25,"2017-18",48.780487804878
"2125",2018-02-09,"Los Angeles Clippers",108,"Detroit Pistons",95,16697,0,-13,13,"2017-18",60.9756097560976
"2126",2018-02-09,"New Orleans Pelicans",82,"Philadelphia 76ers",100,20489,1,18,18,"2017-18",71.7391304347826
"2127",2018-02-09,"Cleveland Cavaliers",123,"Atlanta Hawks",107,16438,0,-16,16,"2017-18",39.0243902439024
"2128",2018-02-09,"Indiana Pacers",97,"Boston Celtics",91,18624,0,-6,6,"2017-18",71.1538461538462
"2129",2018-02-09,"Denver Nuggets",104,"Houston Rockets",130,18055,1,26,26,"2017-18",80.3921568627451
"2130",2018-02-09,"Milwaukee Bucks",85,"Miami Heat",91,20018,1,6,6,"2017-18",60.4651162790698
"2131",2018-02-09,"Charlotte Hornets",94,"Utah Jazz",106,18306,1,12,12,"2017-18",67.3913043478261
"2132",2018-02-09,"Minnesota Timberwolves",113,"Chicago Bulls",114,21558,1,1,1,"2017-18",41.4634146341463
"2133",2018-02-09,"Portland Trail Blazers",118,"Sacramento Kings",100,17583,0,-18,18,"2017-18",34.1463414634146
"2134",2018-02-10,"New Orleans Pelicans",138,"Brooklyn Nets",128,16572,0,-10,10,"2017-18",36.5853658536585
"2135",2018-02-10,"Milwaukee Bucks",111,"Orlando Magic",104,18347,0,-7,7,"2017-18",41.4634146341463
"2136",2018-02-10,"Los Angeles Clippers",98,"Philadelphia 76ers",112,20504,1,14,14,"2017-18",71.7391304347826
"2137",2018-02-10,"Washington Wizards",101,"Chicago Bulls",90,21112,0,-11,11,"2017-18",41.4634146341463
"2138",2018-02-10,"Los Angeles Lakers",123,"Dallas Mavericks",130,20162,1,7,7,"2017-18",36.5853658536585
"2139",2018-02-10,"San Antonio Spurs",105,"Golden State Warriors",122,19596,1,17,17,"2017-18",75
"2140",2018-02-10,"Denver Nuggets",123,"Phoenix Suns",113,16325,0,-10,10,"2017-18",24.390243902439
"2141",2018-02-11,"Toronto Raptors",123,"Charlotte Hornets",103,18320,0,-20,20,"2017-18",51.219512195122
"2142",2018-02-11,"Detroit Pistons",115,"Atlanta Hawks",118,15214,1,3,3,"2017-18",39.0243902439024
"2143",2018-02-11,"Cleveland Cavaliers",121,"Boston Celtics",99,18624,0,-22,22,"2017-18",71.1538461538462
"2144",2018-02-11,"New York Knicks",113,"Indiana Pacers",121,17923,1,8,8,"2017-18",65.9090909090909
"2145",2018-02-11,"Dallas Mavericks",97,"Houston Rockets",104,18055,1,7,7,"2017-18",80.3921568627451
"2146",2018-02-11,"Sacramento Kings",106,"Minnesota Timberwolves",111,18068,1,5,5,"2017-18",72.0930232558139
"2147",2018-02-11,"Memphis Grizzlies",92,"Oklahoma City Thunder",110,18203,1,18,18,"2017-18",65.9090909090909
"2148",2018-02-11,"Utah Jazz",115,"Portland Trail Blazers",96,19730,0,-19,19,"2017-18",65.1162790697674
"2149",2018-02-12,"New Orleans Pelicans",118,"Detroit Pistons",103,14453,0,-15,15,"2017-18",60.9756097560976
"2150",2018-02-12,"New York Knicks",92,"Philadelphia 76ers",108,20589,1,16,16,"2017-18",71.7391304347826
"2151",2018-02-12,"Los Angeles Clippers",114,"Brooklyn Nets",101,13735,0,-13,13,"2017-18",36.5853658536585
"2152",2018-02-12,"Orlando Magic",101,"Chicago Bulls",105,18611,1,4,4,"2017-18",41.4634146341463
"2153",2018-02-12,"San Antonio Spurs",99,"Utah Jazz",101,18306,1,2,2,"2017-18",67.3913043478261
"2154",2018-02-12,"Phoenix Suns",83,"Golden State Warriors",129,19596,1,46,46,"2017-18",75
"2155",2018-02-13,"Miami Heat",112,"Toronto Raptors",115,19800,1,3,3,"2017-18",80.4347826086957
"2156",2018-02-13,"Atlanta Hawks",92,"Milwaukee Bucks",97,14720,1,5,5,"2017-18",63.6363636363636
"2157",2018-02-13,"Houston Rockets",126,"Minnesota Timberwolves",108,18978,0,-18,18,"2017-18",72.0930232558139
"2158",2018-02-13,"Cleveland Cavaliers",120,"Oklahoma City Thunder",112,18203,0,-8,8,"2017-18",65.9090909090909
"2159",2018-02-13,"Sacramento Kings",114,"Dallas Mavericks",109,19801,0,-5,5,"2017-18",36.5853658536585
"2160",2018-02-13,"San Antonio Spurs",109,"Denver Nuggets",117,17623,1,8,8,"2017-18",75.609756097561
"2161",2018-02-14,"Atlanta Hawks",98,"Detroit Pistons",104,15849,1,6,6,"2017-18",60.9756097560976
"2162",2018-02-14,"Charlotte Hornets",104,"Orlando Magic",102,18428,0,-2,2,"2017-18",41.4634146341463
"2163",2018-02-14,"Miami Heat",102,"Philadelphia 76ers",104,20492,1,2,2,"2017-18",71.7391304347826
"2164",2018-02-14,"Indiana Pacers",108,"Brooklyn Nets",103,13159,0,-5,5,"2017-18",36.5853658536585
"2165",2018-02-14,"Washington Wizards",118,"New York Knicks",113,19812,0,-5,5,"2017-18",46.3414634146341
"2166",2018-02-14,"Los Angeles Clippers",129,"Boston Celtics",119,18624,0,-10,10,"2017-18",71.1538461538462
"2167",2018-02-14,"Toronto Raptors",122,"Chicago Bulls",98,21006,0,-24,24,"2017-18",41.4634146341463
"2168",2018-02-14,"Sacramento Kings",91,"Houston Rockets",100,18055,1,9,9,"2017-18",80.3921568627451
"2169",2018-02-14,"Oklahoma City Thunder",121,"Memphis Grizzlies",114,16012,0,-7,7,"2017-18",39.0243902439024
"2170",2018-02-14,"Los Angeles Lakers",117,"New Orleans Pelicans",139,15436,1,22,22,"2017-18",60
"2171",2018-02-14,"Phoenix Suns",97,"Utah Jazz",107,18306,1,10,10,"2017-18",67.3913043478261
"2172",2018-02-14,"Golden State Warriors",117,"Portland Trail Blazers",123,19520,1,6,6,"2017-18",65.1162790697674
"2173",2018-02-15,"Denver Nuggets",134,"Milwaukee Bucks",123,15486,0,-11,11,"2017-18",63.6363636363636
"2174",2018-02-15,"Los Angeles Lakers",111,"Minnesota Timberwolves",119,17534,1,8,8,"2017-18",72.0930232558139
"2175",2018-02-22,"Brooklyn Nets",96,"Charlotte Hornets",111,14112,1,15,15,"2017-18",51.219512195122
"2176",2018-02-22,"New York Knicks",120,"Orlando Magic",113,18846,0,-7,7,"2017-18",41.4634146341463
"2177",2018-02-22,"Philadelphia 76ers",116,"Chicago Bulls",115,21312,0,-1,1,"2017-18",41.4634146341463
"2178",2018-02-22,"Washington Wizards",110,"Cleveland Cavaliers",103,20562,0,-7,7,"2017-18",71.1538461538462
"2179",2018-02-22,"Oklahoma City Thunder",110,"Sacramento Kings",107,17583,0,-3,3,"2017-18",34.1463414634146
"2180",2018-02-22,"Los Angeles Clippers",127,"Golden State Warriors",134,19596,1,7,7,"2017-18",75
"2181",2018-02-23,"Boston Celtics",110,"Detroit Pistons",98,20491,0,-12,12,"2017-18",60.9756097560976
"2182",2018-02-23,"Atlanta Hawks",93,"Indiana Pacers",116,17923,1,23,23,"2017-18",65.9090909090909
"2183",2018-02-23,"Charlotte Hornets",122,"Washington Wizards",105,17824,0,-17,17,"2017-18",56.8181818181818
"2184",2018-02-23,"Milwaukee Bucks",122,"Toronto Raptors",119,20047,0,-3,3,"2017-18",80.4347826086957
"2185",2018-02-23,"Minnesota Timberwolves",102,"Houston Rockets",120,18055,1,18,18,"2017-18",80.3921568627451
"2186",2018-02-23,"Cleveland Cavaliers",112,"Memphis Grizzlies",89,18119,0,-23,23,"2017-18",39.0243902439024
"2187",2018-02-23,"Miami Heat",123,"New Orleans Pelicans",124,17751,1,1,1,"2017-18",60
"2188",2018-02-23,"San Antonio Spurs",119,"Denver Nuggets",122,20027,1,3,3,"2017-18",75.609756097561
"2189",2018-02-23,"Los Angeles Clippers",128,"Phoenix Suns",117,17126,0,-11,11,"2017-18",24.390243902439
"2190",2018-02-23,"Portland Trail Blazers",100,"Utah Jazz",81,18306,0,-19,19,"2017-18",67.3913043478261
"2191",2018-02-23,"Dallas Mavericks",102,"Los Angeles Lakers",124,18997,1,22,22,"2017-18",48.780487804878
"2192",2018-02-24,"Orlando Magic",105,"Philadelphia 76ers",116,20594,1,11,11,"2017-18",71.7391304347826
"2193",2018-02-24,"Memphis Grizzlies",89,"Miami Heat",115,19600,1,26,26,"2017-18",60.4651162790698
"2194",2018-02-24,"Boston Celtics",121,"New York Knicks",112,19812,0,-9,9,"2017-18",46.3414634146341
"2195",2018-02-24,"Oklahoma City Thunder",80,"Golden State Warriors",112,19596,1,32,32,"2017-18",75
"2196",2018-02-24,"Chicago Bulls",104,"Minnesota Timberwolves",122,18978,1,18,18,"2017-18",72.0930232558139
"2197",2018-02-24,"Portland Trail Blazers",106,"Phoenix Suns",104,17112,0,-2,2,"2017-18",24.390243902439
"2198",2018-02-24,"Dallas Mavericks",90,"Utah Jazz",97,18306,1,7,7,"2017-18",67.3913043478261
"2199",2018-02-24,"Los Angeles Lakers",113,"Sacramento Kings",108,17583,0,-5,5,"2017-18",34.1463414634146
"2200",2018-02-25,"Detroit Pistons",98,"Charlotte Hornets",114,17894,1,16,16,"2017-18",51.219512195122
"2201",2018-02-25,"New Orleans Pelicans",123,"Milwaukee Bucks",121,18717,0,-2,2,"2017-18",63.6363636363636
"2202",2018-02-25,"San Antonio Spurs",110,"Cleveland Cavaliers",94,20562,0,-16,16,"2017-18",71.1538461538462
"2203",2018-02-25,"Houston Rockets",119,"Denver Nuggets",114,20044,0,-5,5,"2017-18",75.609756097561
"2204",2018-02-25,"Philadelphia 76ers",94,"Washington Wizards",109,17180,1,15,15,"2017-18",56.8181818181818
"2205",2018-02-26,"Los Angeles Lakers",123,"Atlanta Hawks",104,16328,0,-19,19,"2017-18",39.0243902439024
"2206",2018-02-26,"Memphis Grizzlies",98,"Boston Celtics",109,18624,1,11,11,"2017-18",71.1538461538462
"2207",2018-02-26,"Chicago Bulls",87,"Brooklyn Nets",104,15081,1,17,17,"2017-18",36.5853658536585
"2208",2018-02-26,"Golden State Warriors",125,"New York Knicks",111,19812,0,-14,14,"2017-18",46.3414634146341
"2209",2018-02-26,"Detroit Pistons",94,"Toronto Raptors",123,19800,1,29,29,"2017-18",80.4347826086957
"2210",2018-02-26,"Phoenix Suns",116,"New Orleans Pelicans",125,14302,1,9,9,"2017-18",60
"2211",2018-02-26,"Orlando Magic",105,"Oklahoma City Thunder",112,18203,1,7,7,"2017-18",65.9090909090909
"2212",2018-02-26,"Indiana Pacers",103,"Dallas Mavericks",109,19536,1,6,6,"2017-18",36.5853658536585
"2213",2018-02-26,"Houston Rockets",96,"Utah Jazz",85,18306,0,-11,11,"2017-18",67.3913043478261
"2214",2018-02-26,"Minnesota Timberwolves",118,"Sacramento Kings",100,17583,0,-18,18,"2017-18",34.1463414634146
"2215",2018-02-27,"Chicago Bulls",103,"Charlotte Hornets",118,14521,1,15,15,"2017-18",51.219512195122
"2216",2018-02-27,"Brooklyn Nets",123,"Cleveland Cavaliers",129,20562,1,6,6,"2017-18",71.1538461538462
"2217",2018-02-27,"Philadelphia 76ers",101,"Miami Heat",102,19600,1,1,1,"2017-18",60.4651162790698
"2218",2018-02-27,"Washington Wizards",107,"Milwaukee Bucks",104,16093,0,-3,3,"2017-18",63.6363636363636
"2219",2018-02-27,"Sacramento Kings",99,"Portland Trail Blazers",116,19468,1,17,17,"2017-18",65.1162790697674
"2220",2018-02-27,"Los Angeles Clippers",122,"Denver Nuggets",120,15004,0,-2,2,"2017-18",75.609756097561
"2221",2018-02-28,"Milwaukee Bucks",87,"Detroit Pistons",110,16146,1,23,23,"2017-18",60.9756097560976
"2222",2018-02-28,"Toronto Raptors",117,"Orlando Magic",104,17328,0,-13,13,"2017-18",41.4634146341463
"2223",2018-02-28,"Indiana Pacers",102,"Atlanta Hawks",107,13316,1,5,5,"2017-18",39.0243902439024
"2224",2018-02-28,"Charlotte Hornets",106,"Boston Celtics",134,18624,1,28,28,"2017-18",71.1538461538462
"2225",2018-02-28,"Phoenix Suns",110,"Memphis Grizzlies",102,13484,0,-8,8,"2017-18",39.0243902439024
"2226",2018-02-28,"Golden State Warriors",109,"Washington Wizards",101,20356,0,-8,8,"2017-18",56.8181818181818
"2227",2018-02-28,"Oklahoma City Thunder",111,"Dallas Mavericks",110,20202,0,-1,1,"2017-18",36.5853658536585
"2228",2018-02-28,"New Orleans Pelicans",121,"San Antonio Spurs",116,18418,0,-5,5,"2017-18",79.0697674418605
"2229",2018-02-28,"Houston Rockets",105,"Los Angeles Clippers",92,19068,0,-13,13,"2017-18",53.6585365853659
"2230",2018-03-01,"Los Angeles Lakers",131,"Miami Heat",113,19600,0,-18,18,"2017-18",60.4651162790698
"2231",2018-03-01,"Philadelphia 76ers",108,"Cleveland Cavaliers",97,20562,0,-11,11,"2017-18",71.1538461538462
"2232",2018-03-01,"Brooklyn Nets",111,"Sacramento Kings",116,17583,1,5,5,"2017-18",34.1463414634146
"2233",2018-03-01,"Minnesota Timberwolves",99,"Portland Trail Blazers",108,19533,1,9,9,"2017-18",65.1162790697674
"2234",2018-03-02,"Detroit Pistons",106,"Orlando Magic",115,17223,1,9,9,"2017-18",41.4634146341463
"2235",2018-03-02,"Charlotte Hornets",99,"Philadelphia 76ers",110,20487,1,11,11,"2017-18",71.7391304347826
"2236",2018-03-02,"Golden State Warriors",114,"Atlanta Hawks",109,16728,0,-5,5,"2017-18",39.0243902439024
"2237",2018-03-02,"Dallas Mavericks",100,"Chicago Bulls",108,21017,1,8,8,"2017-18",41.4634146341463
"2238",2018-03-02,"Denver Nuggets",108,"Memphis Grizzlies",102,16421,0,-6,6,"2017-18",39.0243902439024
"2239",2018-03-02,"Indiana Pacers",103,"Milwaukee Bucks",96,17217,0,-7,7,"2017-18",63.6363636363636
"2240",2018-03-02,"Toronto Raptors",102,"Washington Wizards",95,18631,0,-7,7,"2017-18",56.8181818181818
"2241",2018-03-02,"Oklahoma City Thunder",124,"Phoenix Suns",116,18055,0,-8,8,"2017-18",24.390243902439
"2242",2018-03-02,"New York Knicks",105,"Los Angeles Clippers",128,17190,1,23,23,"2017-18",53.6585365853659
"2243",2018-03-02,"Minnesota Timberwolves",108,"Utah Jazz",116,18306,1,8,8,"2017-18",67.3913043478261
"2244",2018-03-03,"Memphis Grizzlies",100,"Orlando Magic",107,17875,1,7,7,"2017-18",41.4634146341463
"2245",2018-03-03,"Denver Nuggets",126,"Cleveland Cavaliers",117,20562,0,-9,9,"2017-18",71.1538461538462
"2246",2018-03-03,"Detroit Pistons",96,"Miami Heat",105,19600,1,9,9,"2017-18",60.4651162790698
"2247",2018-03-03,"Boston Celtics",120,"Houston Rockets",123,18476,1,3,3,"2017-18",80.3921568627451
"2248",2018-03-03,"Los Angeles Lakers",116,"San Antonio Spurs",112,18557,0,-4,4,"2017-18",79.0697674418605
"2249",2018-03-03,"Oklahoma City Thunder",100,"Portland Trail Blazers",108,20063,1,8,8,"2017-18",65.1162790697674
"2250",2018-03-03,"Utah Jazz",98,"Sacramento Kings",91,17583,0,-7,7,"2017-18",34.1463414634146
"2251",2018-03-04,"Phoenix Suns",112,"Atlanta Hawks",113,15166,1,1,1,"2017-18",39.0243902439024
"2252",2018-03-04,"Charlotte Hornets",98,"Toronto Raptors",103,19800,1,5,5,"2017-18",80.4347826086957
"2253",2018-03-04,"Indiana Pacers",98,"Washington Wizards",95,16646,0,-3,3,"2017-18",56.8181818181818
"2254",2018-03-04,"New Orleans Pelicans",126,"Dallas Mavericks",109,19798,0,-17,17,"2017-18",36.5853658536585
"2255",2018-03-04,"Philadelphia 76ers",110,"Milwaukee Bucks",118,15587,1,8,8,"2017-18",63.6363636363636
"2256",2018-03-04,"Brooklyn Nets",120,"Los Angeles Clippers",123,16384,1,3,3,"2017-18",53.6585365853659
"2257",2018-03-04,"New York Knicks",99,"Sacramento Kings",102,17583,1,3,3,"2017-18",34.1463414634146
"2258",2018-03-05,"Detroit Pistons",90,"Cleveland Cavaliers",112,20562,1,22,22,"2017-18",71.1538461538462
"2259",2018-03-05,"Milwaukee Bucks",89,"Indiana Pacers",92,15874,1,3,3,"2017-18",65.9090909090909
"2260",2018-03-05,"Phoenix Suns",103,"Miami Heat",125,19600,1,22,22,"2017-18",60.4651162790698
"2261",2018-03-05,"Boston Celtics",105,"Chicago Bulls",89,21286,0,-16,16,"2017-18",41.4634146341463
"2262",2018-03-05,"Memphis Grizzlies",98,"San Antonio Spurs",100,18418,1,2,2,"2017-18",79.0697674418605
"2263",2018-03-05,"Orlando Magic",80,"Utah Jazz",94,18306,1,14,14,"2017-18",67.3913043478261
"2264",2018-03-05,"Portland Trail Blazers",108,"Los Angeles Lakers",103,18997,0,-5,5,"2017-18",48.780487804878
"2265",2018-03-06,"Philadelphia 76ers",128,"Charlotte Hornets",114,15600,0,-14,14,"2017-18",51.219512195122
"2266",2018-03-06,"Atlanta Hawks",90,"Toronto Raptors",106,19800,1,16,16,"2017-18",80.4347826086957
"2267",2018-03-06,"Miami Heat",113,"Washington Wizards",117,16582,1,4,4,"2017-18",56.8181818181818
"2268",2018-03-06,"Houston Rockets",122,"Oklahoma City Thunder",112,18203,0,-10,10,"2017-18",65.9090909090909
"2269",2018-03-06,"Denver Nuggets",107,"Dallas Mavericks",118,19504,1,11,11,"2017-18",36.5853658536585
"2270",2018-03-06,"New York Knicks",87,"Portland Trail Blazers",111,19393,1,24,24,"2017-18",65.1162790697674
"2271",2018-03-06,"Brooklyn Nets",101,"Golden State Warriors",114,19596,1,13,13,"2017-18",75
"2272",2018-03-06,"New Orleans Pelicans",121,"Los Angeles Clippers",116,16412,0,-5,5,"2017-18",53.6585365853659
"2273",2018-03-07,"Utah Jazz",104,"Indiana Pacers",84,16432,0,-20,20,"2017-18",65.9090909090909
"2274",2018-03-07,"Memphis Grizzlies",110,"Chicago Bulls",119,20210,1,9,9,"2017-18",41.4634146341463
"2275",2018-03-07,"Toronto Raptors",121,"Detroit Pistons",119,17769,0,-2,2,"2017-18",60.9756097560976
"2276",2018-03-07,"Houston Rockets",110,"Milwaukee Bucks",99,17195,0,-11,11,"2017-18",63.6363636363636
"2277",2018-03-07,"New Orleans Pelicans",114,"Sacramento Kings",101,17583,0,-13,13,"2017-18",34.1463414634146
"2278",2018-03-07,"Cleveland Cavaliers",113,"Denver Nuggets",108,20062,0,-5,5,"2017-18",75.609756097561
"2279",2018-03-07,"Orlando Magic",107,"Los Angeles Lakers",108,18997,1,1,1,"2017-18",48.780487804878
"2280",2018-03-08,"Brooklyn Nets",125,"Charlotte Hornets",111,14173,0,-14,14,"2017-18",51.219512195122
"2281",2018-03-08,"Philadelphia 76ers",99,"Miami Heat",108,19600,1,9,9,"2017-18",60.4651162790698
"2282",2018-03-08,"Boston Celtics",117,"Minnesota Timberwolves",109,18978,0,-8,8,"2017-18",72.0930232558139
"2283",2018-03-08,"Phoenix Suns",87,"Oklahoma City Thunder",115,18203,1,28,28,"2017-18",65.9090909090909
"2284",2018-03-08,"San Antonio Spurs",107,"Golden State Warriors",110,19596,1,3,3,"2017-18",75
"2285",2018-03-09,"Chicago Bulls",83,"Detroit Pistons",99,17406,1,16,16,"2017-18",60.9756097560976
"2286",2018-03-09,"Atlanta Hawks",87,"Indiana Pacers",112,17923,1,25,25,"2017-18",65.9090909090909
"2287",2018-03-09,"Houston Rockets",105,"Toronto Raptors",108,20131,1,3,3,"2017-18",80.4347826086957
"2288",2018-03-09,"Utah Jazz",95,"Memphis Grizzlies",78,15622,0,-17,17,"2017-18",39.0243902439024
"2289",2018-03-09,"New York Knicks",112,"Milwaukee Bucks",120,18717,1,8,8,"2017-18",63.6363636363636
"2290",2018-03-09,"Washington Wizards",116,"New Orleans Pelicans",97,18143,0,-19,19,"2017-18",60
"2291",2018-03-09,"Los Angeles Lakers",116,"Denver Nuggets",125,19807,1,9,9,"2017-18",75.609756097561
"2292",2018-03-09,"Golden State Warriors",108,"Portland Trail Blazers",125,19487,1,17,17,"2017-18",65.1162790697674
"2293",2018-03-09,"Orlando Magic",88,"Sacramento Kings",94,17583,1,6,6,"2017-18",34.1463414634146
"2294",2018-03-09,"Cleveland Cavaliers",102,"Los Angeles Clippers",116,19130,1,14,14,"2017-18",53.6585365853659
"2295",2018-03-10,"Phoenix Suns",115,"Charlotte Hornets",122,19336,1,7,7,"2017-18",51.219512195122
"2296",2018-03-10,"Washington Wizards",102,"Miami Heat",129,19689,1,27,27,"2017-18",60.4651162790698
"2297",2018-03-10,"Memphis Grizzlies",80,"Dallas Mavericks",114,19579,1,34,34,"2017-18",36.5853658536585
"2298",2018-03-10,"San Antonio Spurs",94,"Oklahoma City Thunder",104,18203,1,10,10,"2017-18",65.9090909090909
"2299",2018-03-10,"Orlando Magic",105,"Los Angeles Clippers",113,16561,1,8,8,"2017-18",53.6585365853659
"2300",2018-03-11,"Toronto Raptors",132,"New York Knicks",106,19812,0,-26,26,"2017-18",46.3414634146341
"2301",2018-03-11,"Chicago Bulls",129,"Atlanta Hawks",122,15266,0,-7,7,"2017-18",39.0243902439024
"2302",2018-03-11,"Golden State Warriors",103,"Minnesota Timberwolves",109,18978,1,6,6,"2017-18",72.0930232558139
"2303",2018-03-11,"Utah Jazz",116,"New Orleans Pelicans",99,18062,0,-17,17,"2017-18",60
"2304",2018-03-11,"Sacramento Kings",104,"Denver Nuggets",130,19520,1,26,26,"2017-18",75.609756097561
"2305",2018-03-11,"Houston Rockets",105,"Dallas Mavericks",82,20394,0,-23,23,"2017-18",36.5853658536585
"2306",2018-03-11,"Indiana Pacers",99,"Boston Celtics",97,18624,0,-2,2,"2017-18",71.1538461538462
"2307",2018-03-11,"Philadelphia 76ers",120,"Brooklyn Nets",97,16901,0,-23,23,"2017-18",36.5853658536585
"2308",2018-03-11,"Cleveland Cavaliers",113,"Los Angeles Lakers",127,18997,1,14,14,"2017-18",48.780487804878
"2309",2018-03-12,"San Antonio Spurs",93,"Houston Rockets",109,18092,1,16,16,"2017-18",80.3921568627451
"2310",2018-03-12,"Milwaukee Bucks",121,"Memphis Grizzlies",103,14112,0,-18,18,"2017-18",39.0243902439024
"2311",2018-03-12,"Sacramento Kings",101,"Oklahoma City Thunder",106,18203,1,5,5,"2017-18",65.9090909090909
"2312",2018-03-12,"Miami Heat",99,"Portland Trail Blazers",115,19786,1,16,16,"2017-18",65.1162790697674
"2313",2018-03-13,"Indiana Pacers",101,"Philadelphia 76ers",98,20531,0,-3,3,"2017-18",71.7391304347826
"2314",2018-03-13,"Minnesota Timberwolves",116,"Washington Wizards",111,17078,0,-5,5,"2017-18",56.8181818181818
"2315",2018-03-13,"Oklahoma City Thunder",119,"Atlanta Hawks",107,16739,0,-12,12,"2017-18",39.0243902439024
"2316",2018-03-13,"Toronto Raptors",116,"Brooklyn Nets",102,16654,0,-14,14,"2017-18",36.5853658536585
"2317",2018-03-13,"Dallas Mavericks",110,"New York Knicks",97,18597,0,-13,13,"2017-18",46.3414634146341
"2318",2018-03-13,"Los Angeles Clippers",112,"Chicago Bulls",106,20912,0,-6,6,"2017-18",41.4634146341463
"2319",2018-03-13,"Charlotte Hornets",115,"New Orleans Pelicans",119,15507,1,4,4,"2017-18",60
"2320",2018-03-13,"Orlando Magic",72,"San Antonio Spurs",108,18418,1,36,36,"2017-18",79.0697674418605
"2321",2018-03-13,"Detroit Pistons",79,"Utah Jazz",110,18306,1,31,31,"2017-18",67.3913043478261
"2322",2018-03-13,"Cleveland Cavaliers",129,"Phoenix Suns",107,18055,0,-22,22,"2017-18",24.390243902439
"2323",2018-03-13,"Denver Nuggets",103,"Los Angeles Lakers",112,18997,1,9,9,"2017-18",48.780487804878
"2324",2018-03-14,"Milwaukee Bucks",117,"Orlando Magic",126,17713,1,9,9,"2017-18",41.4634146341463
"2325",2018-03-14,"Washington Wizards",125,"Boston Celtics",124,18624,0,-1,1,"2017-18",71.1538461538462
"2326",2018-03-14,"Miami Heat",119,"Sacramento Kings",123,17583,1,4,4,"2017-18",34.1463414634146
"2327",2018-03-14,"Los Angeles Lakers",106,"Golden State Warriors",117,19596,1,11,11,"2017-18",75
"2328",2018-03-15,"Toronto Raptors",106,"Indiana Pacers",99,17923,0,-7,7,"2017-18",65.9090909090909
"2329",2018-03-15,"Charlotte Hornets",129,"Atlanta Hawks",117,14486,0,-12,12,"2017-18",39.0243902439024
"2330",2018-03-15,"Philadelphia 76ers",118,"New York Knicks",110,18894,0,-8,8,"2017-18",46.3414634146341
"2331",2018-03-15,"Los Angeles Clippers",96,"Houston Rockets",101,18055,1,5,5,"2017-18",80.3921568627451
"2332",2018-03-15,"Chicago Bulls",111,"Memphis Grizzlies",110,16511,0,-1,1,"2017-18",39.0243902439024
"2333",2018-03-15,"New Orleans Pelicans",93,"San Antonio Spurs",98,18418,1,5,5,"2017-18",79.0697674418605
"2334",2018-03-15,"Detroit Pistons",113,"Denver Nuggets",120,18697,1,7,7,"2017-18",75.609756097561
"2335",2018-03-15,"Phoenix Suns",88,"Utah Jazz",116,18306,1,28,28,"2017-18",67.3913043478261
"2336",2018-03-15,"Cleveland Cavaliers",105,"Portland Trail Blazers",113,19806,1,8,8,"2017-18",65.1162790697674
"2337",2018-03-16,"Boston Celtics",92,"Orlando Magic",83,18981,0,-9,9,"2017-18",41.4634146341463
"2338",2018-03-16,"Brooklyn Nets",116,"Philadelphia 76ers",120,20666,1,4,4,"2017-18",71.7391304347826
"2339",2018-03-16,"Dallas Mavericks",115,"Toronto Raptors",122,19800,1,7,7,"2017-18",80.4347826086957
"2340",2018-03-16,"Los Angeles Clippers",113,"Oklahoma City Thunder",121,18203,1,8,8,"2017-18",65.9090909090909
"2341",2018-03-16,"Sacramento Kings",98,"Golden State Warriors",93,19596,0,-5,5,"2017-18",75
"2342",2018-03-16,"Miami Heat",92,"Los Angeles Lakers",91,18997,0,-1,1,"2017-18",48.780487804878
"2343",2018-03-17,"Atlanta Hawks",117,"Milwaukee Bucks",122,18717,1,5,5,"2017-18",63.6363636363636
"2344",2018-03-17,"Houston Rockets",107,"New Orleans Pelicans",101,18495,0,-6,6,"2017-18",60
"2345",2018-03-17,"Indiana Pacers",102,"Washington Wizards",109,18249,1,7,7,"2017-18",56.8181818181818
"2346",2018-03-17,"Dallas Mavericks",106,"Brooklyn Nets",114,13877,1,8,8,"2017-18",36.5853658536585
"2347",2018-03-17,"Charlotte Hornets",101,"New York Knicks",124,17760,1,23,23,"2017-18",46.3414634146341
"2348",2018-03-17,"Cleveland Cavaliers",114,"Chicago Bulls",109,22983,0,-5,5,"2017-18",41.4634146341463
"2349",2018-03-17,"Denver Nuggets",94,"Memphis Grizzlies",101,16501,1,7,7,"2017-18",39.0243902439024
"2350",2018-03-17,"Minnesota Timberwolves",101,"San Antonio Spurs",117,18418,1,16,16,"2017-18",79.0697674418605
"2351",2018-03-17,"Sacramento Kings",97,"Utah Jazz",103,18306,1,6,6,"2017-18",67.3913043478261
"2352",2018-03-17,"Golden State Warriors",124,"Phoenix Suns",109,18055,0,-15,15,"2017-18",24.390243902439
"2353",2018-03-17,"Detroit Pistons",87,"Portland Trail Blazers",100,19727,1,13,13,"2017-18",65.1162790697674
"2354",2018-03-18,"Oklahoma City Thunder",132,"Toronto Raptors",125,19800,0,-7,7,"2017-18",80.4347826086957
"2355",2018-03-18,"Boston Celtics",89,"New Orleans Pelicans",108,18277,1,19,19,"2017-18",60
"2356",2018-03-18,"Houston Rockets",129,"Minnesota Timberwolves",120,18978,0,-9,9,"2017-18",72.0930232558139
"2357",2018-03-18,"Portland Trail Blazers",122,"Los Angeles Clippers",109,17776,0,-13,13,"2017-18",53.6585365853659
"2358",2018-03-19,"Milwaukee Bucks",117,"Cleveland Cavaliers",124,20562,1,7,7,"2017-18",71.1538461538462
"2359",2018-03-19,"Los Angeles Lakers",100,"Indiana Pacers",110,16603,1,10,10,"2017-18",65.9090909090909
"2360",2018-03-19,"Charlotte Hornets",94,"Philadelphia 76ers",108,20530,1,14,14,"2017-18",71.7391304347826
"2361",2018-03-19,"Memphis Grizzlies",115,"Brooklyn Nets",118,12856,1,3,3,"2017-18",36.5853658536585
"2362",2018-03-19,"Denver Nuggets",141,"Miami Heat",149,19600,1,8,8,"2017-18",60.4651162790698
"2363",2018-03-19,"Chicago Bulls",92,"New York Knicks",110,18835,1,18,18,"2017-18",46.3414634146341
"2364",2018-03-19,"Golden State Warriors",75,"San Antonio Spurs",89,18418,1,14,14,"2017-18",79.0697674418605
"2365",2018-03-19,"Detroit Pistons",106,"Sacramento Kings",90,17583,0,-16,16,"2017-18",34.1463414634146
"2366",2018-03-20,"Toronto Raptors",93,"Orlando Magic",86,16228,0,-7,7,"2017-18",41.4634146341463
"2367",2018-03-20,"Oklahoma City Thunder",99,"Boston Celtics",100,18624,1,1,1,"2017-18",71.1538461538462
"2368",2018-03-20,"Los Angeles Clippers",109,"Minnesota Timberwolves",123,16351,1,14,14,"2017-18",72.0930232558139
"2369",2018-03-20,"Dallas Mavericks",105,"New Orleans Pelicans",115,14484,1,10,10,"2017-18",60
"2370",2018-03-20,"Atlanta Hawks",99,"Utah Jazz",94,18306,0,-5,5,"2017-18",67.3913043478261
"2371",2018-03-20,"Detroit Pistons",115,"Phoenix Suns",88,17400,0,-27,27,"2017-18",24.390243902439
"2372",2018-03-20,"Houston Rockets",115,"Portland Trail Blazers",111,20012,0,-4,4,"2017-18",65.1162790697674
"2373",2018-03-21,"Toronto Raptors",129,"Cleveland Cavaliers",132,20562,1,3,3,"2017-18",71.1538461538462
"2374",2018-03-21,"Memphis Grizzlies",105,"Philadelphia 76ers",119,10411,1,14,14,"2017-18",71.7391304347826
"2375",2018-03-21,"Charlotte Hornets",111,"Brooklyn Nets",105,10231,0,-6,6,"2017-18",36.5853658536585
"2376",2018-03-21,"New York Knicks",98,"Miami Heat",119,19600,1,21,21,"2017-18",60.4651162790698
"2377",2018-03-21,"Denver Nuggets",135,"Chicago Bulls",102,20671,0,-33,33,"2017-18",41.4634146341463
"2378",2018-03-21,"Los Angeles Clippers",127,"Milwaukee Bucks",120,17916,0,-7,7,"2017-18",63.6363636363636
"2379",2018-03-21,"Indiana Pacers",92,"New Orleans Pelicans",96,14148,1,4,4,"2017-18",60
"2380",2018-03-21,"Washington Wizards",90,"San Antonio Spurs",98,18418,1,8,8,"2017-18",79.0697674418605
"2381",2018-03-22,"Memphis Grizzlies",79,"Charlotte Hornets",140,15033,1,61,61,"2017-18",51.219512195122
"2382",2018-03-22,"Philadelphia 76ers",118,"Orlando Magic",98,17881,0,-20,20,"2017-18",41.4634146341463
"2383",2018-03-22,"Detroit Pistons",96,"Houston Rockets",100,18055,1,4,4,"2017-18",80.3921568627451
"2384",2018-03-22,"Los Angeles Lakers",125,"New Orleans Pelicans",128,18037,1,3,3,"2017-18",60
"2385",2018-03-22,"Utah Jazz",119,"Dallas Mavericks",112,19725,0,-7,7,"2017-18",36.5853658536585
"2386",2018-03-22,"Atlanta Hawks",90,"Sacramento Kings",105,17583,1,15,15,"2017-18",34.1463414634146
"2387",2018-03-23,"Los Angeles Clippers",104,"Indiana Pacers",109,17923,1,5,5,"2017-18",65.9090909090909
"2388",2018-03-23,"Denver Nuggets",108,"Washington Wizards",100,19016,0,-8,8,"2017-18",56.8181818181818
"2389",2018-03-23,"Phoenix Suns",95,"Cleveland Cavaliers",120,20562,1,25,25,"2017-18",71.1538461538462
"2390",2018-03-23,"Minnesota Timberwolves",108,"New York Knicks",104,18914,0,-4,4,"2017-18",46.3414634146341
"2391",2018-03-23,"Brooklyn Nets",112,"Toronto Raptors",116,19800,1,4,4,"2017-18",80.4347826086957
"2392",2018-03-23,"Milwaukee Bucks",118,"Chicago Bulls",105,21698,0,-13,13,"2017-18",41.4634146341463
"2393",2018-03-23,"Miami Heat",99,"Oklahoma City Thunder",105,18203,1,6,6,"2017-18",65.9090909090909
"2394",2018-03-23,"Utah Jazz",120,"San Antonio Spurs",124,18418,1,4,4,"2017-18",79.0697674418605
"2395",2018-03-23,"Boston Celtics",105,"Portland Trail Blazers",100,19575,0,-5,5,"2017-18",65.1162790697674
"2396",2018-03-23,"Atlanta Hawks",94,"Golden State Warriors",106,19596,1,12,12,"2017-18",75
"2397",2018-03-24,"Minnesota Timberwolves",108,"Philadelphia 76ers",120,20668,1,12,12,"2017-18",71.7391304347826
"2398",2018-03-24,"Chicago Bulls",95,"Detroit Pistons",117,19139,1,22,22,"2017-18",60.9756097560976
"2399",2018-03-24,"Phoenix Suns",99,"Orlando Magic",105,17393,1,6,6,"2017-18",41.4634146341463
"2400",2018-03-24,"New Orleans Pelicans",91,"Houston Rockets",114,18055,1,23,23,"2017-18",80.3921568627451
"2401",2018-03-24,"Los Angeles Lakers",100,"Memphis Grizzlies",93,18119,0,-7,7,"2017-18",39.0243902439024
"2402",2018-03-24,"Charlotte Hornets",102,"Dallas Mavericks",98,20085,0,-4,4,"2017-18",36.5853658536585
"2403",2018-03-25,"Cleveland Cavaliers",121,"Brooklyn Nets",114,17732,0,-7,7,"2017-18",36.5853658536585
"2404",2018-03-25,"San Antonio Spurs",103,"Milwaukee Bucks",106,18717,1,3,3,"2017-18",63.6363636363636
"2405",2018-03-25,"Miami Heat",107,"Indiana Pacers",113,17923,1,6,6,"2017-18",65.9090909090909
"2406",2018-03-25,"Boston Celtics",104,"Sacramento Kings",93,17583,0,-11,11,"2017-18",34.1463414634146
"2407",2018-03-25,"Los Angeles Clippers",117,"Toronto Raptors",106,19800,0,-11,11,"2017-18",80.4347826086957
"2408",2018-03-25,"New York Knicks",101,"Washington Wizards",97,18884,0,-4,4,"2017-18",56.8181818181818
"2409",2018-03-25,"Portland Trail Blazers",108,"Oklahoma City Thunder",105,18203,0,-3,3,"2017-18",65.9090909090909
"2410",2018-03-25,"Atlanta Hawks",99,"Houston Rockets",118,18055,1,19,19,"2017-18",80.3921568627451
"2411",2018-03-25,"Utah Jazz",110,"Golden State Warriors",91,19596,0,-19,19,"2017-18",75
"2412",2018-03-26,"New York Knicks",128,"Charlotte Hornets",137,14487,1,9,9,"2017-18",51.219512195122
"2413",2018-03-26,"Los Angeles Lakers",106,"Detroit Pistons",112,18718,1,6,6,"2017-18",60.9756097560976
"2414",2018-03-26,"Denver Nuggets",104,"Philadelphia 76ers",123,20585,1,19,19,"2017-18",71.7391304347826
"2415",2018-03-26,"Memphis Grizzlies",101,"Minnesota Timberwolves",93,16290,0,-8,8,"2017-18",72.0930232558139
"2416",2018-03-26,"Boston Celtics",102,"Phoenix Suns",94,18055,0,-8,8,"2017-18",24.390243902439
"2417",2018-03-27,"San Antonio Spurs",106,"Washington Wizards",116,19588,1,10,10,"2017-18",56.8181818181818
"2418",2018-03-27,"Denver Nuggets",110,"Toronto Raptors",114,19800,1,4,4,"2017-18",80.4347826086957
"2419",2018-03-27,"Chicago Bulls",86,"Houston Rockets",118,18055,1,32,32,"2017-18",80.3921568627451
"2420",2018-03-27,"Cleveland Cavaliers",79,"Miami Heat",98,20093,1,19,19,"2017-18",60.4651162790698
"2421",2018-03-27,"Portland Trail Blazers",107,"New Orleans Pelicans",103,15426,0,-4,4,"2017-18",60
"2422",2018-03-27,"Dallas Mavericks",103,"Sacramento Kings",97,17583,0,-6,6,"2017-18",34.1463414634146
"2423",2018-03-27,"Indiana Pacers",92,"Golden State Warriors",81,19596,0,-11,11,"2017-18",75
"2424",2018-03-27,"Milwaukee Bucks",98,"Los Angeles Clippers",105,19068,1,7,7,"2017-18",53.6585365853659
"2425",2018-03-28,"Cleveland Cavaliers",118,"Charlotte Hornets",105,19474,0,-13,13,"2017-18",51.219512195122
"2426",2018-03-28,"Brooklyn Nets",111,"Orlando Magic",104,16517,0,-7,7,"2017-18",41.4634146341463
"2427",2018-03-28,"New York Knicks",101,"Philadelphia 76ers",118,20655,1,17,17,"2017-18",71.7391304347826
"2428",2018-03-28,"Portland Trail Blazers",103,"Memphis Grizzlies",108,16050,1,5,5,"2017-18",39.0243902439024
"2429",2018-03-28,"Atlanta Hawks",114,"Minnesota Timberwolves",126,16183,1,12,12,"2017-18",72.0930232558139
"2430",2018-03-28,"Boston Celtics",97,"Utah Jazz",94,18306,0,-3,3,"2017-18",67.3913043478261
"2431",2018-03-28,"Los Angeles Clippers",111,"Phoenix Suns",99,17005,0,-12,12,"2017-18",24.390243902439
"2432",2018-03-28,"Dallas Mavericks",93,"Los Angeles Lakers",103,18997,1,10,10,"2017-18",48.780487804878
"2433",2018-03-29,"Washington Wizards",92,"Detroit Pistons",103,18268,1,11,11,"2017-18",60.9756097560976
"2434",2018-03-29,"Chicago Bulls",92,"Miami Heat",103,19746,1,11,11,"2017-18",60.4651162790698
"2435",2018-03-29,"Oklahoma City Thunder",99,"San Antonio Spurs",103,18418,1,4,4,"2017-18",79.0697674418605
"2436",2018-03-29,"Indiana Pacers",106,"Sacramento Kings",103,11360,0,-3,3,"2017-18",34.1463414634146
"2437",2018-03-29,"Milwaukee Bucks",116,"Golden State Warriors",107,19596,0,-9,9,"2017-18",75
"2438",2018-03-30,"Chicago Bulls",90,"Orlando Magic",82,18918,0,-8,8,"2017-18",41.4634146341463
"2439",2018-03-30,"Philadelphia 76ers",101,"Atlanta Hawks",91,16579,0,-10,10,"2017-18",39.0243902439024
"2440",2018-03-30,"New Orleans Pelicans",102,"Cleveland Cavaliers",107,20562,1,5,5,"2017-18",71.1538461538462
"2441",2018-03-30,"Phoenix Suns",103,"Houston Rockets",104,18055,1,1,1,"2017-18",80.3921568627451
"2442",2018-03-30,"Denver Nuggets",126,"Oklahoma City Thunder",125,18203,0,-1,1,"2017-18",65.9090909090909
"2443",2018-03-30,"Minnesota Timberwolves",93,"Dallas Mavericks",92,20244,0,-1,1,"2017-18",36.5853658536585
"2444",2018-03-30,"Memphis Grizzlies",97,"Utah Jazz",107,18306,1,10,10,"2017-18",67.3913043478261
"2445",2018-03-30,"Milwaukee Bucks",124,"Los Angeles Lakers",122,18997,0,-2,2,"2017-18",48.780487804878
"2446",2018-03-30,"Los Angeles Clippers",96,"Portland Trail Blazers",105,20013,1,9,9,"2017-18",65.1162790697674
"2447",2018-03-31,"Charlotte Hornets",93,"Washington Wizards",107,19071,1,14,14,"2017-18",56.8181818181818
"2448",2018-03-31,"Detroit Pistons",115,"New York Knicks",109,19812,0,-6,6,"2017-18",46.3414634146341
"2449",2018-03-31,"Toronto Raptors",99,"Boston Celtics",110,18624,1,11,11,"2017-18",71.1538461538462
"2450",2018-03-31,"Brooklyn Nets",110,"Miami Heat",109,19600,0,-1,1,"2017-18",60.4651162790698
"2451",2018-03-31,"Golden State Warriors",112,"Sacramento Kings",96,17583,0,-16,16,"2017-18",34.1463414634146
"2452",2018-04-01,"Philadelphia 76ers",119,"Charlotte Hornets",102,17005,0,-17,17,"2017-18",51.219512195122
"2453",2018-04-01,"Washington Wizards",94,"Chicago Bulls",113,20466,1,19,19,"2017-18",41.4634146341463
"2454",2018-04-01,"Indiana Pacers",111,"Los Angeles Clippers",104,15866,0,-7,7,"2017-18",53.6585365853659
"2455",2018-04-01,"Houston Rockets",83,"San Antonio Spurs",100,18418,1,17,17,"2017-18",79.0697674418605
"2456",2018-04-01,"Orlando Magic",88,"Atlanta Hawks",94,13587,1,6,6,"2017-18",39.0243902439024
"2457",2018-04-01,"Detroit Pistons",108,"Brooklyn Nets",96,16097,0,-12,12,"2017-18",36.5853658536585
"2458",2018-04-01,"Dallas Mavericks",87,"Cleveland Cavaliers",98,20562,1,11,11,"2017-18",71.1538461538462
"2459",2018-04-01,"Oklahoma City Thunder",109,"New Orleans Pelicans",104,18500,0,-5,5,"2017-18",60
"2460",2018-04-01,"Utah Jazz",121,"Minnesota Timberwolves",97,18978,0,-24,24,"2017-18",72.0930232558139
"2461",2018-04-01,"Milwaukee Bucks",125,"Denver Nuggets",128,19520,1,3,3,"2017-18",75.609756097561
"2462",2018-04-01,"Phoenix Suns",107,"Golden State Warriors",117,19596,1,10,10,"2017-18",75
"2463",2018-04-01,"Memphis Grizzlies",98,"Portland Trail Blazers",113,19545,1,15,15,"2017-18",65.1162790697674
"2464",2018-04-01,"Sacramento Kings",84,"Los Angeles Lakers",83,18997,0,-1,1,"2017-18",48.780487804878
"2465",2018-04-03,"Toronto Raptors",106,"Cleveland Cavaliers",112,20562,1,6,6,"2017-18",71.1538461538462
"2466",2018-04-03,"Brooklyn Nets",95,"Philadelphia 76ers",121,20710,1,26,26,"2017-18",71.7391304347826
"2467",2018-04-03,"Atlanta Hawks",98,"Miami Heat",101,19600,1,3,3,"2017-18",60.4651162790698
"2468",2018-04-03,"Orlando Magic",97,"New York Knicks",73,19812,0,-24,24,"2017-18",46.3414634146341
"2469",2018-04-03,"Charlotte Hornets",114,"Chicago Bulls",120,20139,1,6,6,"2017-18",41.4634146341463
"2470",2018-04-03,"Washington Wizards",104,"Houston Rockets",120,18055,1,16,16,"2017-18",80.3921568627451
"2471",2018-04-03,"Boston Celtics",102,"Milwaukee Bucks",106,16188,1,4,4,"2017-18",63.6363636363636
"2472",2018-04-03,"Golden State Warriors",111,"Oklahoma City Thunder",107,18203,0,-4,4,"2017-18",65.9090909090909
"2473",2018-04-03,"Portland Trail Blazers",109,"Dallas Mavericks",115,19624,1,6,6,"2017-18",36.5853658536585
"2474",2018-04-03,"Indiana Pacers",104,"Denver Nuggets",107,14743,1,3,3,"2017-18",75.609756097561
"2475",2018-04-03,"Los Angeles Lakers",110,"Utah Jazz",117,18306,1,7,7,"2017-18",67.3913043478261
"2476",2018-04-03,"Sacramento Kings",94,"Phoenix Suns",97,16826,1,3,3,"2017-18",24.390243902439
"2477",2018-04-03,"San Antonio Spurs",110,"Los Angeles Clippers",113,17449,1,3,3,"2017-18",53.6585365853659
"2478",2018-04-04,"Philadelphia 76ers",115,"Detroit Pistons",108,18395,0,-7,7,"2017-18",60.9756097560976
"2479",2018-04-04,"Dallas Mavericks",100,"Orlando Magic",105,18112,1,5,5,"2017-18",41.4634146341463
"2480",2018-04-04,"Miami Heat",115,"Atlanta Hawks",86,16696,0,-29,29,"2017-18",39.0243902439024
"2481",2018-04-04,"Memphis Grizzlies",95,"New Orleans Pelicans",123,16521,1,28,28,"2017-18",60
"2482",2018-04-04,"Boston Celtics",78,"Toronto Raptors",96,19963,1,18,18,"2017-18",80.4347826086957
"2483",2018-04-04,"San Antonio Spurs",112,"Los Angeles Lakers",122,18997,1,10,10,"2017-18",48.780487804878
"2484",2018-04-05,"Golden State Warriors",106,"Indiana Pacers",126,17923,1,20,20,"2017-18",65.9090909090909
"2485",2018-04-05,"Washington Wizards",115,"Cleveland Cavaliers",119,20562,1,4,4,"2017-18",71.1538461538462
"2486",2018-04-05,"Portland Trail Blazers",94,"Houston Rockets",96,18055,1,2,2,"2017-18",80.3921568627451
"2487",2018-04-05,"Brooklyn Nets",119,"Milwaukee Bucks",111,18378,0,-8,8,"2017-18",63.6363636363636
"2488",2018-04-05,"Los Angeles Clippers",95,"Utah Jazz",117,18306,1,22,22,"2017-18",67.3913043478261
"2489",2018-04-05,"Minnesota Timberwolves",96,"Denver Nuggets",100,16415,1,4,4,"2017-18",75.609756097561
"2490",2018-04-06,"Dallas Mavericks",106,"Detroit Pistons",113,18768,1,7,7,"2017-18",60.9756097560976
"2491",2018-04-06,"Charlotte Hornets",137,"Orlando Magic",100,17018,0,-37,37,"2017-18",41.4634146341463
"2492",2018-04-06,"Cleveland Cavaliers",130,"Philadelphia 76ers",132,20769,1,2,2,"2017-18",71.7391304347826
"2493",2018-04-06,"Atlanta Hawks",103,"Washington Wizards",97,19557,0,-6,6,"2017-18",56.8181818181818
"2494",2018-04-06,"Chicago Bulls",104,"Boston Celtics",111,18624,1,7,7,"2017-18",71.1538461538462
"2495",2018-04-06,"Miami Heat",98,"New York Knicks",122,19569,1,24,24,"2017-18",46.3414634146341
"2496",2018-04-06,"Indiana Pacers",73,"Toronto Raptors",92,19924,1,19,19,"2017-18",80.4347826086957
"2497",2018-04-06,"Sacramento Kings",94,"Memphis Grizzlies",93,16527,0,-1,1,"2017-18",39.0243902439024
"2498",2018-04-06,"New Orleans Pelicans",122,"Phoenix Suns",103,18055,0,-19,19,"2017-18",24.390243902439
"2499",2018-04-06,"Minnesota Timberwolves",113,"Los Angeles Lakers",96,18997,0,-17,17,"2017-18",48.780487804878
"2500",2018-04-07,"Denver Nuggets",134,"Los Angeles Clippers",115,16166,0,-19,19,"2017-18",53.6585365853659
"2501",2018-04-07,"Milwaukee Bucks",115,"New York Knicks",102,19812,0,-13,13,"2017-18",46.3414634146341
"2502",2018-04-07,"Brooklyn Nets",124,"Chicago Bulls",96,21669,0,-28,28,"2017-18",41.4634146341463
"2503",2018-04-07,"New Orleans Pelicans",126,"Golden State Warriors",120,19596,0,-6,6,"2017-18",75
"2504",2018-04-07,"Oklahoma City Thunder",108,"Houston Rockets",102,18055,0,-6,6,"2017-18",80.3921568627451
"2505",2018-04-07,"Portland Trail Blazers",105,"San Antonio Spurs",116,18610,1,11,11,"2017-18",79.0697674418605
"2506",2018-04-08,"Atlanta Hawks",112,"Boston Celtics",106,18624,0,-6,6,"2017-18",71.1538461538462
"2507",2018-04-08,"Indiana Pacers",123,"Charlotte Hornets",117,16629,0,-6,6,"2017-18",51.219512195122
"2508",2018-04-08,"Dallas Mavericks",97,"Philadelphia 76ers",109,20846,1,12,12,"2017-18",71.7391304347826
"2509",2018-04-08,"Detroit Pistons",117,"Memphis Grizzlies",130,16044,1,13,13,"2017-18",39.0243902439024
"2510",2018-04-08,"Utah Jazz",112,"Los Angeles Lakers",97,18997,0,-15,15,"2017-18",48.780487804878
"2511",2018-04-08,"Orlando Magic",101,"Toronto Raptors",112,19948,1,11,11,"2017-18",80.4347826086957
"2512",2018-04-08,"Golden State Warriors",117,"Phoenix Suns",100,18055,0,-17,17,"2017-18",24.390243902439
"2513",2018-04-09,"Toronto Raptors",108,"Detroit Pistons",98,17529,0,-10,10,"2017-18",60.9756097560976
"2514",2018-04-09,"Chicago Bulls",105,"Brooklyn Nets",114,16187,1,9,9,"2017-18",36.5853658536585
"2515",2018-04-09,"Oklahoma City Thunder",115,"Miami Heat",93,19600,0,-22,22,"2017-18",60.4651162790698
"2516",2018-04-09,"Cleveland Cavaliers",123,"New York Knicks",109,19449,0,-14,14,"2017-18",46.3414634146341
"2517",2018-04-09,"Orlando Magic",86,"Milwaukee Bucks",102,18717,1,16,16,"2017-18",63.6363636363636
"2518",2018-04-09,"Memphis Grizzlies",94,"Minnesota Timberwolves",113,17641,1,19,19,"2017-18",72.0930232558139
"2519",2018-04-09,"Sacramento Kings",85,"San Antonio Spurs",98,18418,1,13,13,"2017-18",79.0697674418605
"2520",2018-04-09,"Portland Trail Blazers",82,"Denver Nuggets",88,17467,1,6,6,"2017-18",75.609756097561
"2521",2018-04-09,"New Orleans Pelicans",113,"Los Angeles Clippers",100,15742,0,-13,13,"2017-18",53.6585365853659
"2522",2018-04-10,"Charlotte Hornets",119,"Indiana Pacers",93,17331,0,-26,26,"2017-18",65.9090909090909
"2523",2018-04-10,"Philadelphia 76ers",121,"Atlanta Hawks",113,15673,0,-8,8,"2017-18",39.0243902439024
"2524",2018-04-10,"Boston Celtics",101,"Washington Wizards",113,18887,1,12,12,"2017-18",56.8181818181818
"2525",2018-04-10,"Phoenix Suns",124,"Dallas Mavericks",97,20041,0,-27,27,"2017-18",36.5853658536585
"2526",2018-04-10,"Golden State Warriors",79,"Utah Jazz",119,18306,1,40,40,"2017-18",67.3913043478261
"2527",2018-04-10,"Houston Rockets",105,"Los Angeles Lakers",99,18997,0,-6,6,"2017-18",48.780487804878
"2528",2018-04-11,"Brooklyn Nets",97,"Boston Celtics",110,18624,1,13,13,"2017-18",71.1538461538462
"2529",2018-04-11,"Detroit Pistons",119,"Chicago Bulls",87,21342,0,-32,32,"2017-18",41.4634146341463
"2530",2018-04-11,"New York Knicks",110,"Cleveland Cavaliers",98,20562,0,-12,12,"2017-18",71.1538461538462
"2531",2018-04-11,"Toronto Raptors",109,"Miami Heat",116,19600,1,7,7,"2017-18",60.4651162790698
"2532",2018-04-11,"Denver Nuggets",106,"Minnesota Timberwolves",112,18978,1,6,6,"2017-18",72.0930232558139
"2533",2018-04-11,"San Antonio Spurs",98,"New Orleans Pelicans",122,18573,1,24,24,"2017-18",60
"2534",2018-04-11,"Memphis Grizzlies",123,"Oklahoma City Thunder",137,18203,1,14,14,"2017-18",65.9090909090909
"2535",2018-04-11,"Washington Wizards",92,"Orlando Magic",101,17598,1,9,9,"2017-18",41.4634146341463
"2536",2018-04-11,"Milwaukee Bucks",95,"Philadelphia 76ers",130,20659,1,35,35,"2017-18",71.7391304347826
"2537",2018-04-11,"Los Angeles Lakers",115,"Los Angeles Clippers",100,19068,0,-15,15,"2017-18",53.6585365853659
"2538",2018-04-11,"Utah Jazz",93,"Portland Trail Blazers",102,20186,1,9,9,"2017-18",65.1162790697674
"2539",2018-04-11,"Houston Rockets",83,"Sacramento Kings",96,17583,1,13,13,"2017-18",34.1463414634146
"2540",2018-04-14,"San Antonio Spurs",92,"Golden State Warriors",113,19596,1,21,21,"2017-18",75
"2541",2018-04-14,"Washington Wizards",106,"Toronto Raptors",114,19937,1,8,8,"2017-18",80.4347826086957
"2542",2018-04-14,"Miami Heat",103,"Philadelphia 76ers",130,20617,1,27,27,"2017-18",71.7391304347826
"2543",2018-04-14,"New Orleans Pelicans",97,"Portland Trail Blazers",95,19882,0,-2,2,"2017-18",65.1162790697674
"2544",2018-04-15,"Milwaukee Bucks",107,"Boston Celtics",113,18624,1,6,6,"2017-18",71.1538461538462
"2545",2018-04-15,"Indiana Pacers",98,"Cleveland Cavaliers",80,20562,0,-18,18,"2017-18",71.1538461538462
"2546",2018-04-15,"Utah Jazz",108,"Oklahoma City Thunder",116,18203,1,8,8,"2017-18",65.9090909090909
"2547",2018-04-15,"Minnesota Timberwolves",101,"Houston Rockets",104,18055,1,3,3,"2017-18",80.3921568627451
"2548",2018-04-16,"Miami Heat",113,"Philadelphia 76ers",103,20753,0,-10,10,"2017-18",71.7391304347826
"2549",2018-04-16,"San Antonio Spurs",101,"Golden State Warriors",116,19596,1,15,15,"2017-18",75
"2550",2018-04-17,"Washington Wizards",119,"Toronto Raptors",130,20242,1,11,11,"2017-18",80.4347826086957
"2551",2018-04-17,"Milwaukee Bucks",106,"Boston Celtics",120,18624,1,14,14,"2017-18",71.1538461538462
"2552",2018-04-17,"New Orleans Pelicans",111,"Portland Trail Blazers",102,20066,0,-9,9,"2017-18",65.1162790697674
"2553",2018-04-18,"Indiana Pacers",97,"Cleveland Cavaliers",100,20562,1,3,3,"2017-18",71.1538461538462
"2554",2018-04-18,"Utah Jazz",102,"Oklahoma City Thunder",95,18203,0,-7,7,"2017-18",65.9090909090909
"2555",2018-04-18,"Minnesota Timberwolves",82,"Houston Rockets",102,18055,1,20,20,"2017-18",80.3921568627451
"2556",2018-04-19,"Philadelphia 76ers",128,"Miami Heat",108,19812,0,-20,20,"2017-18",60.4651162790698
"2557",2018-04-19,"Portland Trail Blazers",102,"New Orleans Pelicans",119,18551,1,17,17,"2017-18",60
"2558",2018-04-19,"Golden State Warriors",110,"San Antonio Spurs",97,18418,0,-13,13,"2017-18",79.0697674418605
"2559",2018-04-20,"Cleveland Cavaliers",90,"Indiana Pacers",92,17923,1,2,2,"2017-18",65.9090909090909
"2560",2018-04-20,"Toronto Raptors",103,"Washington Wizards",122,20356,1,19,19,"2017-18",56.8181818181818
"2561",2018-04-20,"Boston Celtics",92,"Milwaukee Bucks",116,18717,1,24,24,"2017-18",63.6363636363636
"2562",2018-04-21,"Philadelphia 76ers",106,"Miami Heat",102,19804,0,-4,4,"2017-18",60.4651162790698
"2563",2018-04-21,"Portland Trail Blazers",123,"New Orleans Pelicans",131,18544,1,8,8,"2017-18",60
"2564",2018-04-21,"Houston Rockets",105,"Minnesota Timberwolves",121,18978,1,16,16,"2017-18",72.0930232558139
"2565",2018-04-21,"Oklahoma City Thunder",102,"Utah Jazz",115,18306,1,13,13,"2017-18",67.3913043478261
"2566",2018-04-22,"Boston Celtics",102,"Milwaukee Bucks",104,18717,1,2,2,"2017-18",63.6363636363636
"2567",2018-04-22,"Golden State Warriors",90,"San Antonio Spurs",103,18418,1,13,13,"2017-18",79.0697674418605
"2568",2018-04-22,"Toronto Raptors",98,"Washington Wizards",106,20356,1,8,8,"2017-18",56.8181818181818
"2569",2018-04-22,"Cleveland Cavaliers",104,"Indiana Pacers",100,17923,0,-4,4,"2017-18",65.9090909090909
"2570",2018-04-23,"Houston Rockets",119,"Minnesota Timberwolves",100,18978,0,-19,19,"2017-18",72.0930232558139
"2571",2018-04-23,"Oklahoma City Thunder",96,"Utah Jazz",113,18306,1,17,17,"2017-18",67.3913043478261
"2572",2018-04-24,"Milwaukee Bucks",87,"Boston Celtics",92,18624,1,5,5,"2017-18",71.1538461538462
"2573",2018-04-24,"Miami Heat",91,"Philadelphia 76ers",104,21171,1,13,13,"2017-18",71.7391304347826
"2574",2018-04-24,"San Antonio Spurs",91,"Golden State Warriors",99,19596,1,8,8,"2017-18",75
"2575",2018-04-25,"Indiana Pacers",95,"Cleveland Cavaliers",98,20562,1,3,3,"2017-18",71.1538461538462
"2576",2018-04-25,"Washington Wizards",98,"Toronto Raptors",108,19987,1,10,10,"2017-18",80.4347826086957
"2577",2018-04-25,"Minnesota Timberwolves",104,"Houston Rockets",122,18055,1,18,18,"2017-18",80.3921568627451
"2578",2018-04-25,"Utah Jazz",99,"Oklahoma City Thunder",107,18203,1,8,8,"2017-18",65.9090909090909
"2579",2018-04-26,"Boston Celtics",86,"Milwaukee Bucks",97,18717,1,11,11,"2017-18",63.6363636363636
"2580",2018-04-27,"Toronto Raptors",102,"Washington Wizards",92,20356,0,-10,10,"2017-18",56.8181818181818
"2581",2018-04-27,"Cleveland Cavaliers",87,"Indiana Pacers",121,17923,1,34,34,"2017-18",65.9090909090909
"2582",2018-04-27,"Oklahoma City Thunder",91,"Utah Jazz",96,18306,1,5,5,"2017-18",67.3913043478261
"2583",2018-04-28,"Milwaukee Bucks",96,"Boston Celtics",112,18624,1,16,16,"2017-18",71.1538461538462
"2584",2018-04-28,"New Orleans Pelicans",101,"Golden State Warriors",123,19596,1,22,22,"2017-18",75
"2585",2018-04-29,"Indiana Pacers",101,"Cleveland Cavaliers",105,20562,1,4,4,"2017-18",71.1538461538462
"2586",2018-04-29,"Utah Jazz",96,"Houston Rockets",110,18055,1,14,14,"2017-18",80.3921568627451
"2587",2018-04-30,"Philadelphia 76ers",101,"Boston Celtics",117,18624,1,16,16,"2017-18",71.1538461538462
"2588",2018-05-01,"Cleveland Cavaliers",113,"Toronto Raptors",112,19954,0,-1,1,"2017-18",80.4347826086957
"2589",2018-05-01,"New Orleans Pelicans",116,"Golden State Warriors",121,19596,1,5,5,"2017-18",75
"2590",2018-05-02,"Utah Jazz",116,"Houston Rockets",108,18055,0,-8,8,"2017-18",80.3921568627451
"2591",2018-05-03,"Cleveland Cavaliers",128,"Toronto Raptors",110,20127,0,-18,18,"2017-18",80.4347826086957
"2592",2018-05-03,"Philadelphia 76ers",103,"Boston Celtics",108,18624,1,5,5,"2017-18",71.1538461538462
"2593",2018-05-04,"Golden State Warriors",100,"New Orleans Pelicans",119,18551,1,19,19,"2017-18",60
"2594",2018-05-04,"Houston Rockets",113,"Utah Jazz",92,18306,0,-21,21,"2017-18",67.3913043478261
"2595",2018-05-05,"Boston Celtics",101,"Philadelphia 76ers",98,20758,0,-3,3,"2017-18",71.7391304347826
"2596",2018-05-05,"Toronto Raptors",103,"Cleveland Cavaliers",105,20562,1,2,2,"2017-18",71.1538461538462
"2597",2018-05-06,"Golden State Warriors",118,"New Orleans Pelicans",92,18513,0,-26,26,"2017-18",60
"2598",2018-05-06,"Houston Rockets",100,"Utah Jazz",87,18306,0,-13,13,"2017-18",67.3913043478261
"2599",2018-05-07,"Boston Celtics",92,"Philadelphia 76ers",103,20936,1,11,11,"2017-18",71.7391304347826
"2600",2018-05-07,"Toronto Raptors",93,"Cleveland Cavaliers",128,20562,1,35,35,"2017-18",71.1538461538462
"2601",2018-05-08,"Utah Jazz",102,"Houston Rockets",112,18055,1,10,10,"2017-18",80.3921568627451
"2602",2018-05-08,"New Orleans Pelicans",104,"Golden State Warriors",113,19596,1,9,9,"2017-18",75
"2603",2018-05-09,"Philadelphia 76ers",112,"Boston Celtics",114,18624,1,2,2,"2017-18",71.1538461538462
"2604",2018-05-13,"Cleveland Cavaliers",83,"Boston Celtics",108,18624,1,25,25,"2017-18",71.1538461538462
"2605",2018-05-14,"Golden State Warriors",119,"Houston Rockets",106,18055,0,-13,13,"2017-18",80.3921568627451
"2606",2018-05-15,"Cleveland Cavaliers",94,"Boston Celtics",107,18624,1,13,13,"2017-18",71.1538461538462
"2607",2018-05-16,"Golden State Warriors",105,"Houston Rockets",127,18119,1,22,22,"2017-18",80.3921568627451
"2608",2018-05-19,"Boston Celtics",86,"Cleveland Cavaliers",116,20562,1,30,30,"2017-18",71.1538461538462
"2609",2018-05-20,"Houston Rockets",85,"Golden State Warriors",126,19596,1,41,41,"2017-18",75
"2610",2018-05-21,"Boston Celtics",102,"Cleveland Cavaliers",111,20562,1,9,9,"2017-18",71.1538461538462
"2611",2018-05-22,"Houston Rockets",95,"Golden State Warriors",92,19596,0,-3,3,"2017-18",75
"2612",2018-05-23,"Cleveland Cavaliers",83,"Boston Celtics",96,18624,1,13,13,"2017-18",71.1538461538462
"2613",2018-05-24,"Golden State Warriors",94,"Houston Rockets",98,18208,1,4,4,"2017-18",80.3921568627451
"2614",2018-05-25,"Boston Celtics",99,"Cleveland Cavaliers",109,20562,1,10,10,"2017-18",71.1538461538462
"2615",2018-05-26,"Houston Rockets",86,"Golden State Warriors",115,19596,1,29,29,"2017-18",75
"2616",2018-05-27,"Cleveland Cavaliers",87,"Boston Celtics",79,18624,0,-8,8,"2017-18",71.1538461538462
"2617",2018-05-28,"Golden State Warriors",101,"Houston Rockets",92,18055,0,-9,9,"2017-18",80.3921568627451
"2618",2018-05-31,"Cleveland Cavaliers",114,"Golden State Warriors",124,19596,1,10,10,"2017-18",75
"2619",2018-06-03,"Cleveland Cavaliers",103,"Golden State Warriors",122,19596,1,19,19,"2017-18",75
"2620",2018-06-06,"Golden State Warriors",110,"Cleveland Cavaliers",102,20562,0,-8,8,"2017-18",71.1538461538462
"2621",2018-06-08,"Golden State Warriors",108,"Cleveland Cavaliers",85,20562,0,-23,23,"2017-18",71.1538461538462
"2622",2018-10-16,"Philadelphia 76ers",87,"Boston Celtics",105,18624,1,18,18,"2018-19",66.6666666666667
"2623",2018-10-16,"Oklahoma City Thunder",100,"Golden State Warriors",108,19596,1,8,8,"2018-19",69.2307692307692
"2624",2018-10-17,"Milwaukee Bucks",113,"Charlotte Hornets",112,17889,0,-1,1,"2018-19",60.9756097560976
"2625",2018-10-17,"Brooklyn Nets",100,"Detroit Pistons",103,20332,1,3,3,"2018-19",60.4651162790698
"2626",2018-10-17,"Memphis Grizzlies",83,"Indiana Pacers",111,17923,1,28,28,"2018-19",67.4418604651163
"2627",2018-10-17,"Miami Heat",101,"Orlando Magic",104,19191,1,3,3,"2018-19",58.1395348837209
"2628",2018-10-17,"Atlanta Hawks",107,"New York Knicks",126,18249,1,19,19,"2018-19",21.9512195121951
"2629",2018-10-17,"Cleveland Cavaliers",104,"Toronto Raptors",116,19915,1,12,12,"2018-19",75.9259259259259
"2630",2018-10-17,"New Orleans Pelicans",131,"Houston Rockets",112,18055,0,-19,19,"2018-19",76.5957446808511
"2631",2018-10-17,"Minnesota Timberwolves",108,"San Antonio Spurs",112,18354,1,4,4,"2018-19",77.2727272727273
"2632",2018-10-17,"Utah Jazz",123,"Sacramento Kings",117,17583,0,-6,6,"2018-19",58.5365853658537
"2633",2018-10-17,"Denver Nuggets",107,"Los Angeles Clippers",98,19068,0,-9,9,"2018-19",59.0909090909091
"2634",2018-10-17,"Dallas Mavericks",100,"Phoenix Suns",121,18055,1,21,21,"2018-19",29.2682926829268
"2635",2018-10-18,"Chicago Bulls",108,"Philadelphia 76ers",127,20302,1,19,19,"2018-19",74.468085106383
"2636",2018-10-18,"Miami Heat",113,"Washington Wizards",112,20409,0,-1,1,"2018-19",53.6585365853659
"2637",2018-10-18,"Los Angeles Lakers",119,"Portland Trail Blazers",128,19996,1,9,9,"2018-19",75.5102040816327
"2638",2018-10-19,"Charlotte Hornets",120,"Orlando Magic",88,17668,0,-32,32,"2018-19",58.1395348837209
"2639",2018-10-19,"New York Knicks",105,"Brooklyn Nets",107,17732,1,2,2,"2018-19",53.4883720930233
"2640",2018-10-19,"Atlanta Hawks",117,"Memphis Grizzlies",131,17019,1,14,14,"2018-19",51.219512195122
"2641",2018-10-19,"Cleveland Cavaliers",123,"Minnesota Timberwolves",131,18978,1,8,8,"2018-19",60.9756097560976
"2642",2018-10-19,"Sacramento Kings",129,"New Orleans Pelicans",149,18337,1,20,20,"2018-19",46.3414634146341
"2643",2018-10-19,"Boston Celtics",101,"Toronto Raptors",113,19800,1,12,12,"2018-19",75.9259259259259
"2644",2018-10-19,"Indiana Pacers",101,"Milwaukee Bucks",118,17341,1,17,17,"2018-19",79.5918367346939
"2645",2018-10-19,"Oklahoma City Thunder",92,"Los Angeles Clippers",108,14816,1,16,16,"2018-19",59.0909090909091
"2646",2018-10-19,"Golden State Warriors",124,"Utah Jazz",123,18306,0,-1,1,"2018-19",69.7674418604651
"2647",2018-10-20,"Brooklyn Nets",112,"Indiana Pacers",132,17007,1,20,20,"2018-19",67.4418604651163
"2648",2018-10-20,"Toronto Raptors",117,"Washington Wizards",113,16185,0,-4,4,"2018-19",53.6585365853659
"2649",2018-10-20,"Boston Celtics",103,"New York Knicks",101,19427,0,-2,2,"2018-19",21.9512195121951
"2650",2018-10-20,"Orlando Magic",115,"Philadelphia 76ers",116,20300,1,1,1,"2018-19",74.468085106383
"2651",2018-10-20,"Detroit Pistons",118,"Chicago Bulls",116,21289,0,-2,2,"2018-19",21.9512195121951
"2652",2018-10-20,"Charlotte Hornets",113,"Miami Heat",112,19600,0,-1,1,"2018-19",46.3414634146341
"2653",2018-10-20,"Minnesota Timberwolves",136,"Dallas Mavericks",140,20205,1,4,4,"2018-19",58.5365853658537
"2654",2018-10-20,"Phoenix Suns",91,"Denver Nuggets",119,19592,1,28,28,"2018-19",79.5918367346939
"2655",2018-10-20,"San Antonio Spurs",108,"Portland Trail Blazers",121,19461,1,13,13,"2018-19",75.5102040816327
"2656",2018-10-20,"Houston Rockets",124,"Los Angeles Lakers",115,18997,0,-9,9,"2018-19",53.6585365853659
"2657",2018-10-21,"Atlanta Hawks",133,"Cleveland Cavaliers",111,19432,0,-22,22,"2018-19",31.7073170731707
"2658",2018-10-21,"Sacramento Kings",131,"Oklahoma City Thunder",120,18203,0,-11,11,"2018-19",65.1162790697674
"2659",2018-10-21,"Golden State Warriors",98,"Denver Nuggets",100,19520,1,2,2,"2018-19",79.5918367346939
"2660",2018-10-21,"Houston Rockets",112,"Los Angeles Clippers",115,16149,1,3,3,"2018-19",59.0909090909091
"2661",2018-10-22,"Orlando Magic",93,"Boston Celtics",90,18624,0,-3,3,"2018-19",66.6666666666667
"2662",2018-10-22,"Charlotte Hornets",106,"Toronto Raptors",127,19800,1,21,21,"2018-19",75.9259259259259
"2663",2018-10-22,"New York Knicks",113,"Milwaukee Bucks",124,16228,1,11,11,"2018-19",79.5918367346939
"2664",2018-10-22,"Indiana Pacers",91,"Minnesota Timberwolves",101,10371,1,10,10,"2018-19",60.9756097560976
"2665",2018-10-22,"Chicago Bulls",109,"Dallas Mavericks",115,19291,1,6,6,"2018-19",58.5365853658537
"2666",2018-10-22,"Memphis Grizzlies",92,"Utah Jazz",84,18306,0,-8,8,"2018-19",69.7674418604651
"2667",2018-10-22,"Washington Wizards",125,"Portland Trail Blazers",124,19187,0,-1,1,"2018-19",75.5102040816327
"2668",2018-10-22,"Phoenix Suns",103,"Golden State Warriors",123,19596,1,20,20,"2018-19",69.2307692307692
"2669",2018-10-22,"San Antonio Spurs",143,"Los Angeles Lakers",142,18997,0,-1,1,"2018-19",53.6585365853659
"2670",2018-10-23,"Philadelphia 76ers",132,"Detroit Pistons",133,14418,1,1,1,"2018-19",60.4651162790698
"2671",2018-10-23,"Los Angeles Clippers",109,"New Orleans Pelicans",116,14625,1,7,7,"2018-19",46.3414634146341
"2672",2018-10-23,"Sacramento Kings",112,"Denver Nuggets",126,13214,1,14,14,"2018-19",79.5918367346939
"2673",2018-10-24,"Dallas Mavericks",104,"Atlanta Hawks",111,16705,1,7,7,"2018-19",41.4634146341463
"2674",2018-10-24,"Brooklyn Nets",102,"Cleveland Cavaliers",86,19432,0,-16,16,"2018-19",31.7073170731707
"2675",2018-10-24,"New York Knicks",87,"Miami Heat",110,19600,1,23,23,"2018-19",46.3414634146341
"2676",2018-10-24,"Minnesota Timberwolves",105,"Toronto Raptors",112,19800,1,7,7,"2018-19",75.9259259259259
"2677",2018-10-24,"Charlotte Hornets",110,"Chicago Bulls",112,19170,1,2,2,"2018-19",21.9512195121951
"2678",2018-10-24,"Utah Jazz",100,"Houston Rockets",89,18055,0,-11,11,"2018-19",76.5957446808511
"2679",2018-10-24,"Indiana Pacers",116,"San Antonio Spurs",96,18354,0,-20,20,"2018-19",77.2727272727273
"2680",2018-10-24,"Philadelphia 76ers",108,"Milwaukee Bucks",123,17341,1,15,15,"2018-19",79.5918367346939
"2681",2018-10-24,"Los Angeles Lakers",131,"Phoenix Suns",113,18055,0,-18,18,"2018-19",29.2682926829268
"2682",2018-10-24,"Memphis Grizzlies",92,"Sacramento Kings",97,14198,1,5,5,"2018-19",58.5365853658537
"2683",2018-10-24,"Washington Wizards",122,"Golden State Warriors",144,19596,1,22,22,"2018-19",69.2307692307692
"2684",2018-10-25,"Cleveland Cavaliers",103,"Detroit Pistons",110,15896,1,7,7,"2018-19",60.4651162790698
"2685",2018-10-25,"Portland Trail Blazers",128,"Orlando Magic",114,15114,0,-14,14,"2018-19",58.1395348837209
"2686",2018-10-25,"Boston Celtics",101,"Oklahoma City Thunder",95,18203,0,-6,6,"2018-19",65.1162790697674
"2687",2018-10-25,"Denver Nuggets",114,"Los Angeles Lakers",121,18997,1,7,7,"2018-19",53.6585365853659
"2688",2018-10-26,"Chicago Bulls",106,"Charlotte Hornets",135,15220,1,29,29,"2018-19",60.9756097560976
"2689",2018-10-26,"Golden State Warriors",128,"New York Knicks",100,19812,0,-28,28,"2018-19",21.9512195121951
"2690",2018-10-26,"Dallas Mavericks",107,"Toronto Raptors",116,19800,1,9,9,"2018-19",75.9259259259259
"2691",2018-10-26,"Los Angeles Clippers",133,"Houston Rockets",113,18055,0,-20,20,"2018-19",76.5957446808511
"2692",2018-10-26,"Milwaukee Bucks",125,"Minnesota Timberwolves",95,16334,0,-30,30,"2018-19",60.9756097560976
"2693",2018-10-26,"Brooklyn Nets",115,"New Orleans Pelicans",117,15272,1,2,2,"2018-19",46.3414634146341
"2694",2018-10-26,"Washington Wizards",112,"Sacramento Kings",116,14101,1,4,4,"2018-19",58.5365853658537
"2695",2018-10-27,"Boston Celtics",109,"Detroit Pistons",89,18120,0,-20,20,"2018-19",60.4651162790698
"2696",2018-10-27,"Utah Jazz",132,"New Orleans Pelicans",111,16373,0,-21,21,"2018-19",46.3414634146341
"2697",2018-10-27,"Chicago Bulls",97,"Atlanta Hawks",85,15549,0,-12,12,"2018-19",41.4634146341463
"2698",2018-10-27,"Indiana Pacers",119,"Cleveland Cavaliers",107,19432,0,-12,12,"2018-19",31.7073170731707
"2699",2018-10-27,"Charlotte Hornets",103,"Philadelphia 76ers",105,20203,1,2,2,"2018-19",74.468085106383
"2700",2018-10-27,"Phoenix Suns",96,"Memphis Grizzlies",117,15926,1,21,21,"2018-19",51.219512195122
"2701",2018-10-27,"Portland Trail Blazers",111,"Miami Heat",120,19600,1,9,9,"2018-19",46.3414634146341
"2702",2018-10-27,"Orlando Magic",91,"Milwaukee Bucks",113,17341,1,22,22,"2018-19",79.5918367346939
"2703",2018-10-27,"Los Angeles Lakers",106,"San Antonio Spurs",110,18589,1,4,4,"2018-19",77.2727272727273
"2704",2018-10-28,"Golden State Warriors",120,"Brooklyn Nets",114,17732,0,-6,6,"2018-19",53.4883720930233
"2705",2018-10-28,"Utah Jazz",113,"Dallas Mavericks",104,19571,0,-9,9,"2018-19",58.5365853658537
"2706",2018-10-28,"Phoenix Suns",110,"Oklahoma City Thunder",117,18203,1,7,7,"2018-19",65.1162790697674
"2707",2018-10-28,"Washington Wizards",104,"Los Angeles Clippers",136,16491,1,32,32,"2018-19",59.0909090909091
"2708",2018-10-29,"Portland Trail Blazers",103,"Indiana Pacers",93,15788,0,-10,10,"2018-19",67.4418604651163
"2709",2018-10-29,"Atlanta Hawks",92,"Philadelphia 76ers",113,20269,1,21,21,"2018-19",74.468085106383
"2710",2018-10-29,"Sacramento Kings",123,"Miami Heat",113,19600,0,-10,10,"2018-19",46.3414634146341
"2711",2018-10-29,"Brooklyn Nets",96,"New York Knicks",115,19221,1,19,19,"2018-19",21.9512195121951
"2712",2018-10-29,"Golden State Warriors",149,"Chicago Bulls",124,21076,0,-25,25,"2018-19",21.9512195121951
"2713",2018-10-29,"Toronto Raptors",109,"Milwaukee Bucks",124,17341,1,15,15,"2018-19",79.5918367346939
"2714",2018-10-29,"Los Angeles Lakers",120,"Minnesota Timberwolves",124,18978,1,4,4,"2018-19",60.9756097560976
"2715",2018-10-29,"Dallas Mavericks",108,"San Antonio Spurs",113,18354,1,5,5,"2018-19",77.2727272727273
"2716",2018-10-29,"New Orleans Pelicans",111,"Denver Nuggets",116,15217,1,5,5,"2018-19",79.5918367346939
"2717",2018-10-30,"Miami Heat",113,"Charlotte Hornets",125,14117,1,12,12,"2018-19",60.9756097560976
"2718",2018-10-30,"Atlanta Hawks",114,"Cleveland Cavaliers",136,19432,1,22,22,"2018-19",31.7073170731707
"2719",2018-10-30,"Sacramento Kings",107,"Orlando Magic",99,15074,0,-8,8,"2018-19",58.1395348837209
"2720",2018-10-30,"Detroit Pistons",105,"Boston Celtics",108,18624,1,3,3,"2018-19",66.6666666666667
"2721",2018-10-30,"Philadelphia 76ers",112,"Toronto Raptors",129,19800,1,17,17,"2018-19",75.9259259259259
"2722",2018-10-30,"Portland Trail Blazers",104,"Houston Rockets",85,18055,0,-19,19,"2018-19",76.5957446808511
"2723",2018-10-30,"Washington Wizards",95,"Memphis Grizzlies",107,14106,1,12,12,"2018-19",51.219512195122
"2724",2018-10-30,"Los Angeles Clippers",110,"Oklahoma City Thunder",128,18203,1,18,18,"2018-19",65.1162790697674
"2725",2018-10-31,"Detroit Pistons",119,"Brooklyn Nets",120,12862,1,1,1,"2018-19",53.4883720930233
"2726",2018-10-31,"Denver Nuggets",108,"Chicago Bulls",107,19027,0,-1,1,"2018-19",21.9512195121951
"2727",2018-10-31,"Utah Jazz",125,"Minnesota Timberwolves",128,10079,1,3,3,"2018-19",60.9756097560976
"2728",2018-10-31,"Indiana Pacers",107,"New York Knicks",101,18295,0,-6,6,"2018-19",21.9512195121951
"2729",2018-10-31,"New Orleans Pelicans",121,"Golden State Warriors",131,19596,1,10,10,"2018-19",69.2307692307692
"2730",2018-10-31,"Dallas Mavericks",113,"Los Angeles Lakers",114,18997,1,1,1,"2018-19",53.6585365853659
"2731",2018-10-31,"San Antonio Spurs",120,"Phoenix Suns",90,12328,0,-30,30,"2018-19",29.2682926829268
"2732",2018-11-01,"Oklahoma City Thunder",111,"Charlotte Hornets",107,14583,0,-4,4,"2018-19",60.9756097560976
"2733",2018-11-01,"Denver Nuggets",110,"Cleveland Cavaliers",91,19432,0,-19,19,"2018-19",31.7073170731707
"2734",2018-11-01,"Los Angeles Clippers",113,"Philadelphia 76ers",122,20246,1,9,9,"2018-19",74.468085106383
"2735",2018-11-01,"Sacramento Kings",146,"Atlanta Hawks",115,12095,0,-31,31,"2018-19",41.4634146341463
"2736",2018-11-01,"Milwaukee Bucks",113,"Boston Celtics",117,18624,1,4,4,"2018-19",66.6666666666667
"2737",2018-11-01,"New Orleans Pelicans",119,"Portland Trail Blazers",132,18921,1,13,13,"2018-19",75.5102040816327
"2738",2018-11-02,"Los Angeles Clippers",120,"Orlando Magic",95,15953,0,-25,25,"2018-19",58.1395348837209
"2739",2018-11-02,"Houston Rockets",119,"Brooklyn Nets",111,14013,0,-8,8,"2018-19",53.4883720930233
"2740",2018-11-02,"Indiana Pacers",107,"Chicago Bulls",105,19704,0,-2,2,"2018-19",21.9512195121951
"2741",2018-11-02,"Oklahoma City Thunder",134,"Washington Wizards",111,20409,0,-23,23,"2018-19",53.6585365853659
"2742",2018-11-02,"New York Knicks",118,"Dallas Mavericks",106,20008,0,-12,12,"2018-19",58.5365853658537
"2743",2018-11-02,"Memphis Grizzlies",110,"Utah Jazz",100,18306,0,-10,10,"2018-19",69.7674418604651
"2744",2018-11-02,"Toronto Raptors",107,"Phoenix Suns",98,15843,0,-9,9,"2018-19",29.2682926829268
"2745",2018-11-02,"Minnesota Timberwolves",99,"Golden State Warriors",116,19596,1,17,17,"2018-19",69.2307692307692
"2746",2018-11-03,"Detroit Pistons",99,"Philadelphia 76ers",109,20289,1,10,10,"2018-19",74.468085106383
"2747",2018-11-03,"Cleveland Cavaliers",94,"Charlotte Hornets",126,16221,1,32,32,"2018-19",60.9756097560976
"2748",2018-11-03,"Boston Celtics",101,"Indiana Pacers",102,17505,1,1,1,"2018-19",67.4418604651163
"2749",2018-11-03,"Miami Heat",118,"Atlanta Hawks",123,16303,1,5,5,"2018-19",41.4634146341463
"2750",2018-11-03,"Houston Rockets",96,"Chicago Bulls",88,20505,0,-8,8,"2018-19",21.9512195121951
"2751",2018-11-03,"New Orleans Pelicans",95,"San Antonio Spurs",109,18354,1,14,14,"2018-19",77.2727272727273
"2752",2018-11-03,"Utah Jazz",88,"Denver Nuggets",103,19520,1,15,15,"2018-19",79.5918367346939
"2753",2018-11-03,"Los Angeles Lakers",114,"Portland Trail Blazers",110,19848,0,-4,4,"2018-19",75.5102040816327
"2754",2018-11-04,"Sacramento Kings",109,"Milwaukee Bucks",144,17341,1,35,35,"2018-19",79.5918367346939
"2755",2018-11-04,"Philadelphia 76ers",97,"Brooklyn Nets",122,12826,1,25,25,"2018-19",53.4883720930233
"2756",2018-11-04,"New York Knicks",95,"Washington Wizards",108,16679,1,13,13,"2018-19",53.6585365853659
"2757",2018-11-04,"Orlando Magic",117,"San Antonio Spurs",110,18354,0,-7,7,"2018-19",77.2727272727273
"2758",2018-11-04,"Memphis Grizzlies",100,"Phoenix Suns",102,13074,1,2,2,"2018-19",29.2682926829268
"2759",2018-11-04,"Minnesota Timberwolves",81,"Portland Trail Blazers",111,19522,1,30,30,"2018-19",75.5102040816327
"2760",2018-11-04,"Toronto Raptors",121,"Los Angeles Lakers",107,18997,0,-14,14,"2018-19",53.6585365853659
"2761",2018-11-05,"Miami Heat",120,"Detroit Pistons",115,14148,0,-5,5,"2018-19",60.4651162790698
"2762",2018-11-05,"Houston Rockets",98,"Indiana Pacers",94,14735,0,-4,4,"2018-19",67.4418604651163
"2763",2018-11-05,"Cleveland Cavaliers",100,"Orlando Magic",102,15009,1,2,2,"2018-19",58.1395348837209
"2764",2018-11-05,"Chicago Bulls",116,"New York Knicks",115,19812,0,-1,1,"2018-19",21.9512195121951
"2765",2018-11-05,"New Orleans Pelicans",116,"Oklahoma City Thunder",122,18203,1,6,6,"2018-19",65.1162790697674
"2766",2018-11-05,"Boston Celtics",107,"Denver Nuggets",115,19520,1,8,8,"2018-19",79.5918367346939
"2767",2018-11-05,"Toronto Raptors",124,"Utah Jazz",111,18306,0,-13,13,"2018-19",69.7674418604651
"2768",2018-11-05,"Memphis Grizzlies",101,"Golden State Warriors",117,19596,1,16,16,"2018-19",69.2307692307692
"2769",2018-11-05,"Minnesota Timberwolves",109,"Los Angeles Clippers",120,16564,1,11,11,"2018-19",59.0909090909091
"2770",2018-11-06,"Atlanta Hawks",102,"Charlotte Hornets",113,13955,1,11,11,"2018-19",60.9756097560976
"2771",2018-11-06,"Washington Wizards",100,"Dallas Mavericks",119,19234,1,19,19,"2018-19",58.5365853658537
"2772",2018-11-06,"Brooklyn Nets",104,"Phoenix Suns",82,14205,0,-22,22,"2018-19",29.2682926829268
"2773",2018-11-06,"Milwaukee Bucks",103,"Portland Trail Blazers",118,19512,1,15,15,"2018-19",75.5102040816327
"2774",2018-11-07,"Oklahoma City Thunder",95,"Cleveland Cavaliers",86,19432,0,-9,9,"2018-19",31.7073170731707
"2775",2018-11-07,"Detroit Pistons",103,"Orlando Magic",96,16103,0,-7,7,"2018-19",58.1395348837209
"2776",2018-11-07,"New York Knicks",112,"Atlanta Hawks",107,12412,0,-5,5,"2018-19",41.4634146341463
"2777",2018-11-07,"San Antonio Spurs",88,"Miami Heat",95,19600,1,7,7,"2018-19",46.3414634146341
"2778",2018-11-07,"Philadelphia 76ers",100,"Indiana Pacers",94,16434,0,-6,6,"2018-19",67.4418604651163
"2779",2018-11-07,"Denver Nuggets",87,"Memphis Grizzlies",89,15832,1,2,2,"2018-19",51.219512195122
"2780",2018-11-07,"Chicago Bulls",98,"New Orleans Pelicans",107,15514,1,9,9,"2018-19",46.3414634146341
"2781",2018-11-07,"Dallas Mavericks",102,"Utah Jazz",117,18306,1,15,15,"2018-19",69.7674418604651
"2782",2018-11-07,"Toronto Raptors",114,"Sacramento Kings",105,17583,0,-9,9,"2018-19",58.5365853658537
"2783",2018-11-07,"Minnesota Timberwolves",110,"Los Angeles Lakers",114,18997,1,4,4,"2018-19",53.6585365853659
"2784",2018-11-08,"Houston Rockets",80,"Oklahoma City Thunder",98,18203,1,18,18,"2018-19",65.1162790697674
"2785",2018-11-08,"Boston Celtics",116,"Phoenix Suns",109,17359,0,-7,7,"2018-19",29.2682926829268
"2786",2018-11-08,"Los Angeles Clippers",105,"Portland Trail Blazers",116,19170,1,11,11,"2018-19",75.5102040816327
"2787",2018-11-08,"Milwaukee Bucks",134,"Golden State Warriors",111,19596,0,-23,23,"2018-19",69.2307692307692
"2788",2018-11-09,"Washington Wizards",108,"Orlando Magic",117,16562,1,9,9,"2018-19",58.1395348837209
"2789",2018-11-09,"Charlotte Hornets",132,"Philadelphia 76ers",133,20424,1,1,1,"2018-19",74.468085106383
"2790",2018-11-09,"Detroit Pistons",124,"Atlanta Hawks",109,14759,0,-15,15,"2018-19",41.4634146341463
"2791",2018-11-09,"Indiana Pacers",110,"Miami Heat",102,19600,0,-8,8,"2018-19",46.3414634146341
"2792",2018-11-09,"Brooklyn Nets",112,"Denver Nuggets",110,19520,0,-2,2,"2018-19",79.5918367346939
"2793",2018-11-09,"Boston Celtics",115,"Utah Jazz",123,18306,1,8,8,"2018-19",69.7674418604651
"2794",2018-11-09,"Minnesota Timberwolves",110,"Sacramento Kings",121,17583,1,11,11,"2018-19",58.5365853658537
"2795",2018-11-10,"New York Knicks",112,"Toronto Raptors",128,19800,1,16,16,"2018-19",75.9259259259259
"2796",2018-11-10,"Milwaukee Bucks",126,"Los Angeles Clippers",128,17486,1,2,2,"2018-19",59.0909090909091
"2797",2018-11-10,"Phoenix Suns",99,"New Orleans Pelicans",119,15222,1,20,20,"2018-19",46.3414634146341
"2798",2018-11-10,"Cleveland Cavaliers",98,"Chicago Bulls",99,21506,1,1,1,"2018-19",21.9512195121951
"2799",2018-11-10,"Philadelphia 76ers",106,"Memphis Grizzlies",112,16904,1,6,6,"2018-19",51.219512195122
"2800",2018-11-10,"Washington Wizards",116,"Miami Heat",110,19600,0,-6,6,"2018-19",46.3414634146341
"2801",2018-11-10,"Brooklyn Nets",100,"Golden State Warriors",116,19596,1,16,16,"2018-19",69.2307692307692
"2802",2018-11-10,"Houston Rockets",89,"San Antonio Spurs",96,18354,1,7,7,"2018-19",77.2727272727273
"2803",2018-11-10,"Oklahoma City Thunder",96,"Dallas Mavericks",111,19818,1,15,15,"2018-19",58.5365853658537
"2804",2018-11-10,"Los Angeles Lakers",101,"Sacramento Kings",86,17583,0,-15,15,"2018-19",58.5365853658537
"2805",2018-11-11,"Charlotte Hornets",113,"Detroit Pistons",103,15133,0,-10,10,"2018-19",60.4651162790698
"2806",2018-11-11,"Indiana Pacers",103,"Houston Rockets",115,18055,1,12,12,"2018-19",76.5957446808511
"2807",2018-11-11,"Orlando Magic",115,"New York Knicks",89,19812,0,-26,26,"2018-19",21.9512195121951
"2808",2018-11-11,"Milwaukee Bucks",121,"Denver Nuggets",114,19520,0,-7,7,"2018-19",79.5918367346939
"2809",2018-11-11,"Boston Celtics",94,"Portland Trail Blazers",100,19712,1,6,6,"2018-19",75.5102040816327
"2810",2018-11-11,"Atlanta Hawks",106,"Los Angeles Lakers",107,18997,1,1,1,"2018-19",53.6585365853659
"2811",2018-11-12,"Orlando Magic",109,"Washington Wizards",117,15346,1,8,8,"2018-19",53.6585365853659
"2812",2018-11-12,"Philadelphia 76ers",124,"Miami Heat",114,19600,0,-10,10,"2018-19",46.3414634146341
"2813",2018-11-12,"New Orleans Pelicans",126,"Toronto Raptors",110,19800,0,-16,16,"2018-19",75.9259259259259
"2814",2018-11-12,"Dallas Mavericks",103,"Chicago Bulls",98,19012,0,-5,5,"2018-19",21.9512195121951
"2815",2018-11-12,"Utah Jazz",96,"Memphis Grizzlies",88,13477,0,-8,8,"2018-19",51.219512195122
"2816",2018-11-12,"Brooklyn Nets",113,"Minnesota Timberwolves",120,10186,1,7,7,"2018-19",60.9756097560976
"2817",2018-11-12,"Phoenix Suns",101,"Oklahoma City Thunder",118,18203,1,17,17,"2018-19",65.1162790697674
"2818",2018-11-12,"San Antonio Spurs",99,"Sacramento Kings",104,15500,1,5,5,"2018-19",58.5365853658537
"2819",2018-11-12,"Golden State Warriors",116,"Los Angeles Clippers",121,19068,1,5,5,"2018-19",59.0909090909091
"2820",2018-11-13,"Charlotte Hornets",89,"Cleveland Cavaliers",113,19432,1,24,24,"2018-19",31.7073170731707
"2821",2018-11-13,"Houston Rockets",109,"Denver Nuggets",99,16741,0,-10,10,"2018-19",79.5918367346939
"2822",2018-11-13,"Atlanta Hawks",103,"Golden State Warriors",110,19596,1,7,7,"2018-19",69.2307692307692
"2823",2018-11-14,"Philadelphia 76ers",106,"Orlando Magic",111,15921,1,5,5,"2018-19",58.1395348837209
"2824",2018-11-14,"Cleveland Cavaliers",95,"Washington Wizards",119,14537,1,24,24,"2018-19",53.6585365853659
"2825",2018-11-14,"Chicago Bulls",82,"Boston Celtics",111,18624,1,29,29,"2018-19",66.6666666666667
"2826",2018-11-14,"Miami Heat",120,"Brooklyn Nets",107,13317,0,-13,13,"2018-19",53.4883720930233
"2827",2018-11-14,"Detroit Pistons",106,"Toronto Raptors",104,19800,0,-2,2,"2018-19",75.9259259259259
"2828",2018-11-14,"Memphis Grizzlies",116,"Milwaukee Bucks",113,16817,0,-3,3,"2018-19",79.5918367346939
"2829",2018-11-14,"New Orleans Pelicans",100,"Minnesota Timberwolves",107,11636,1,7,7,"2018-19",60.9756097560976
"2830",2018-11-14,"New York Knicks",103,"Oklahoma City Thunder",128,18203,1,25,25,"2018-19",65.1162790697674
"2831",2018-11-14,"Utah Jazz",68,"Dallas Mavericks",118,19371,1,50,50,"2018-19",58.5365853658537
"2832",2018-11-14,"San Antonio Spurs",96,"Phoenix Suns",116,14532,1,20,20,"2018-19",29.2682926829268
"2833",2018-11-14,"Portland Trail Blazers",117,"Los Angeles Lakers",126,18997,1,9,9,"2018-19",53.6585365853659
"2834",2018-11-15,"Golden State Warriors",86,"Houston Rockets",107,18055,1,21,21,"2018-19",76.5957446808511
"2835",2018-11-15,"Atlanta Hawks",93,"Denver Nuggets",138,15103,1,45,45,"2018-19",79.5918367346939
"2836",2018-11-15,"San Antonio Spurs",111,"Los Angeles Clippers",116,17463,1,5,5,"2018-19",59.0909090909091
"2837",2018-11-16,"Toronto Raptors",116,"Boston Celtics",123,18624,1,7,7,"2018-19",66.6666666666667
"2838",2018-11-16,"Miami Heat",91,"Indiana Pacers",99,17923,1,8,8,"2018-19",67.4418604651163
"2839",2018-11-16,"Utah Jazz",107,"Philadelphia 76ers",113,20485,1,6,6,"2018-19",74.468085106383
"2840",2018-11-16,"Brooklyn Nets",115,"Washington Wizards",104,15102,0,-11,11,"2018-19",53.6585365853659
"2841",2018-11-16,"Sacramento Kings",104,"Memphis Grizzlies",112,13811,1,8,8,"2018-19",51.219512195122
"2842",2018-11-16,"Portland Trail Blazers",96,"Minnesota Timberwolves",112,18978,1,16,16,"2018-19",60.9756097560976
"2843",2018-11-16,"New York Knicks",124,"New Orleans Pelicans",129,14717,1,5,5,"2018-19",46.3414634146341
"2844",2018-11-16,"Chicago Bulls",104,"Milwaukee Bucks",123,17341,1,19,19,"2018-19",79.5918367346939
"2845",2018-11-17,"Los Angeles Clippers",127,"Brooklyn Nets",119,12944,0,-8,8,"2018-19",53.4883720930233
"2846",2018-11-17,"Philadelphia 76ers",122,"Charlotte Hornets",119,19426,0,-3,3,"2018-19",60.9756097560976
"2847",2018-11-17,"Atlanta Hawks",89,"Indiana Pacers",97,17491,1,8,8,"2018-19",67.4418604651163
"2848",2018-11-17,"Denver Nuggets",115,"New Orleans Pelicans",125,15408,1,10,10,"2018-19",46.3414634146341
"2849",2018-11-17,"Los Angeles Lakers",117,"Orlando Magic",130,19249,1,13,13,"2018-19",58.1395348837209
"2850",2018-11-17,"Utah Jazz",98,"Boston Celtics",86,18624,0,-12,12,"2018-19",66.6666666666667
"2851",2018-11-17,"Toronto Raptors",122,"Chicago Bulls",83,21263,0,-39,39,"2018-19",21.9512195121951
"2852",2018-11-17,"Sacramento Kings",112,"Houston Rockets",132,18055,1,20,20,"2018-19",76.5957446808511
"2853",2018-11-17,"Golden State Warriors",109,"Dallas Mavericks",112,20260,1,3,3,"2018-19",58.5365853658537
"2854",2018-11-17,"Oklahoma City Thunder",110,"Phoenix Suns",100,16376,0,-10,10,"2018-19",29.2682926829268
"2855",2018-11-18,"Memphis Grizzlies",100,"Minnesota Timberwolves",87,13179,0,-13,13,"2018-19",60.9756097560976
"2856",2018-11-18,"Los Angeles Lakers",113,"Miami Heat",97,19686,0,-16,16,"2018-19",46.3414634146341
"2857",2018-11-18,"New York Knicks",117,"Orlando Magic",131,15898,1,14,14,"2018-19",58.1395348837209
"2858",2018-11-18,"Portland Trail Blazers",119,"Washington Wizards",109,16647,0,-10,10,"2018-19",53.6585365853659
"2859",2018-11-18,"Golden State Warriors",92,"San Antonio Spurs",104,18354,1,12,12,"2018-19",77.2727272727273
"2860",2018-11-19,"Boston Celtics",112,"Charlotte Hornets",117,18040,1,5,5,"2018-19",60.9756097560976
"2861",2018-11-19,"Cleveland Cavaliers",102,"Detroit Pistons",113,15769,1,11,11,"2018-19",60.4651162790698
"2862",2018-11-19,"Utah Jazz",94,"Indiana Pacers",121,17000,1,27,27,"2018-19",67.4418604651163
"2863",2018-11-19,"Phoenix Suns",114,"Philadelphia 76ers",119,20459,1,5,5,"2018-19",74.468085106383
"2864",2018-11-19,"Los Angeles Clippers",127,"Atlanta Hawks",119,14323,0,-8,8,"2018-19",41.4634146341463
"2865",2018-11-19,"Dallas Mavericks",88,"Memphis Grizzlies",98,15997,1,10,10,"2018-19",51.219512195122
"2866",2018-11-19,"Denver Nuggets",98,"Milwaukee Bucks",104,17341,1,6,6,"2018-19",79.5918367346939
"2867",2018-11-19,"San Antonio Spurs",126,"New Orleans Pelicans",140,14675,1,14,14,"2018-19",46.3414634146341
"2868",2018-11-19,"Oklahoma City Thunder",113,"Sacramento Kings",117,16250,1,4,4,"2018-19",58.5365853658537
"2869",2018-11-20,"Toronto Raptors",93,"Orlando Magic",91,16016,0,-2,2,"2018-19",58.1395348837209
"2870",2018-11-20,"Los Angeles Clippers",118,"Washington Wizards",125,14499,1,7,7,"2018-19",53.6585365853659
"2871",2018-11-20,"Brooklyn Nets",104,"Miami Heat",92,19600,0,-12,12,"2018-19",46.3414634146341
"2872",2018-11-20,"Portland Trail Blazers",118,"New York Knicks",114,19812,0,-4,4,"2018-19",21.9512195121951
"2873",2018-11-21,"Indiana Pacers",109,"Charlotte Hornets",127,15913,1,18,18,"2018-19",60.9756097560976
"2874",2018-11-21,"New Orleans Pelicans",120,"Philadelphia 76ers",121,20352,1,1,1,"2018-19",74.468085106383
"2875",2018-11-21,"Toronto Raptors",124,"Atlanta Hawks",108,15058,0,-16,16,"2018-19",41.4634146341463
"2876",2018-11-21,"New York Knicks",117,"Boston Celtics",109,18624,0,-8,8,"2018-19",66.6666666666667
"2877",2018-11-21,"Phoenix Suns",116,"Chicago Bulls",124,19014,1,8,8,"2018-19",21.9512195121951
"2878",2018-11-21,"Los Angeles Lakers",109,"Cleveland Cavaliers",105,19432,0,-4,4,"2018-19",31.7073170731707
"2879",2018-11-21,"Detroit Pistons",124,"Houston Rockets",126,18055,1,2,2,"2018-19",76.5957446808511
"2880",2018-11-21,"Portland Trail Blazers",100,"Milwaukee Bucks",143,17591,1,43,43,"2018-19",79.5918367346939
"2881",2018-11-21,"Denver Nuggets",103,"Minnesota Timberwolves",101,15086,0,-2,2,"2018-19",60.9756097560976
"2882",2018-11-21,"Brooklyn Nets",113,"Dallas Mavericks",119,19926,1,6,6,"2018-19",58.5365853658537
"2883",2018-11-21,"Memphis Grizzlies",104,"San Antonio Spurs",103,18354,0,-1,1,"2018-19",77.2727272727273
"2884",2018-11-21,"Sacramento Kings",119,"Utah Jazz",110,18306,0,-9,9,"2018-19",69.7674418604651
"2885",2018-11-21,"Oklahoma City Thunder",123,"Golden State Warriors",95,19596,0,-28,28,"2018-19",69.2307692307692
"2886",2018-11-23,"Minnesota Timberwolves",112,"Brooklyn Nets",102,12814,0,-10,10,"2018-19",53.4883720930233
"2887",2018-11-23,"Memphis Grizzlies",107,"Los Angeles Clippers",112,15418,1,5,5,"2018-19",59.0909090909091
"2888",2018-11-23,"Houston Rockets",111,"Detroit Pistons",116,17268,1,5,5,"2018-19",60.4651162790698
"2889",2018-11-23,"Boston Celtics",114,"Atlanta Hawks",96,15017,0,-18,18,"2018-19",41.4634146341463
"2890",2018-11-23,"New Orleans Pelicans",109,"New York Knicks",114,18948,1,5,5,"2018-19",21.9512195121951
"2891",2018-11-23,"Cleveland Cavaliers",121,"Philadelphia 76ers",112,20524,0,-9,9,"2018-19",74.468085106383
"2892",2018-11-23,"Washington Wizards",107,"Toronto Raptors",125,19800,1,18,18,"2018-19",75.9259259259259
"2893",2018-11-23,"Miami Heat",103,"Chicago Bulls",96,20935,0,-7,7,"2018-19",21.9512195121951
"2894",2018-11-23,"San Antonio Spurs",111,"Indiana Pacers",100,17262,0,-11,11,"2018-19",67.4418604651163
"2895",2018-11-23,"Charlotte Hornets",104,"Oklahoma City Thunder",109,18203,1,5,5,"2018-19",65.1162790697674
"2896",2018-11-23,"Phoenix Suns",116,"Milwaukee Bucks",114,17852,0,-2,2,"2018-19",79.5918367346939
"2897",2018-11-23,"Orlando Magic",87,"Denver Nuggets",112,19520,1,25,25,"2018-19",79.5918367346939
"2898",2018-11-23,"Portland Trail Blazers",97,"Golden State Warriors",125,19596,1,28,28,"2018-19",69.2307692307692
"2899",2018-11-23,"Utah Jazz",83,"Los Angeles Lakers",90,18997,1,7,7,"2018-19",53.6585365853659
"2900",2018-11-24,"Houston Rockets",108,"Cleveland Cavaliers",117,19432,1,9,9,"2018-19",31.7073170731707
"2901",2018-11-24,"Chicago Bulls",96,"Minnesota Timberwolves",111,17119,1,15,15,"2018-19",60.9756097560976
"2902",2018-11-24,"Denver Nuggets",105,"Oklahoma City Thunder",98,18203,0,-7,7,"2018-19",65.1162790697674
"2903",2018-11-24,"New Orleans Pelicans",114,"Washington Wizards",124,15165,1,10,10,"2018-19",53.6585365853659
"2904",2018-11-24,"Boston Celtics",104,"Dallas Mavericks",113,20226,1,9,9,"2018-19",58.5365853658537
"2905",2018-11-24,"Sacramento Kings",116,"Golden State Warriors",117,19596,1,1,1,"2018-19",69.2307692307692
"2906",2018-11-24,"San Antonio Spurs",129,"Milwaukee Bucks",135,17559,1,6,6,"2018-19",79.5918367346939
"2907",2018-11-25,"Orlando Magic",108,"Los Angeles Lakers",104,18997,0,-4,4,"2018-19",53.6585365853659
"2908",2018-11-25,"Phoenix Suns",107,"Detroit Pistons",118,14413,1,11,11,"2018-19",60.4651162790698
"2909",2018-11-25,"Charlotte Hornets",123,"Atlanta Hawks",124,12977,1,1,1,"2018-19",41.4634146341463
"2910",2018-11-25,"Philadelphia 76ers",127,"Brooklyn Nets",125,15217,0,-2,2,"2018-19",53.4883720930233
"2911",2018-11-25,"New York Knicks",103,"Memphis Grizzlies",98,14331,0,-5,5,"2018-19",51.219512195122
"2912",2018-11-25,"Miami Heat",115,"Toronto Raptors",125,19800,1,10,10,"2018-19",75.9259259259259
"2913",2018-11-25,"Utah Jazz",133,"Sacramento Kings",112,16048,0,-21,21,"2018-19",58.5365853658537
"2914",2018-11-25,"Los Angeles Clippers",104,"Portland Trail Blazers",100,19138,0,-4,4,"2018-19",75.5102040816327
"2915",2018-11-26,"Milwaukee Bucks",107,"Charlotte Hornets",110,13805,1,3,3,"2018-19",60.9756097560976
"2916",2018-11-26,"Minnesota Timberwolves",102,"Cleveland Cavaliers",95,19432,0,-7,7,"2018-19",31.7073170731707
"2917",2018-11-26,"Houston Rockets",131,"Washington Wizards",135,16872,1,4,4,"2018-19",53.6585365853659
"2918",2018-11-26,"San Antonio Spurs",108,"Chicago Bulls",107,19006,0,-1,1,"2018-19",21.9512195121951
"2919",2018-11-26,"Boston Celtics",124,"New Orleans Pelicans",107,15189,0,-17,17,"2018-19",46.3414634146341
"2920",2018-11-26,"Indiana Pacers",121,"Utah Jazz",88,18306,0,-33,33,"2018-19",69.7674418604651
"2921",2018-11-26,"Orlando Magic",110,"Golden State Warriors",116,19596,1,6,6,"2018-19",69.2307692307692
"2922",2018-11-27,"New York Knicks",108,"Detroit Pistons",115,13935,1,7,7,"2018-19",60.4651162790698
"2923",2018-11-27,"Atlanta Hawks",115,"Miami Heat",113,19600,0,-2,2,"2018-19",46.3414634146341
"2924",2018-11-27,"Toronto Raptors",122,"Memphis Grizzlies",114,14187,0,-8,8,"2018-19",51.219512195122
"2925",2018-11-27,"Los Angeles Lakers",85,"Denver Nuggets",117,19583,1,32,32,"2018-19",79.5918367346939
"2926",2018-11-27,"Indiana Pacers",109,"Phoenix Suns",104,13038,0,-5,5,"2018-19",29.2682926829268
"2927",2018-11-28,"Atlanta Hawks",94,"Charlotte Hornets",108,12971,1,14,14,"2018-19",60.9756097560976
"2928",2018-11-28,"New York Knicks",91,"Philadelphia 76ers",117,20274,1,26,26,"2018-19",74.468085106383
"2929",2018-11-28,"Utah Jazz",101,"Brooklyn Nets",91,12928,0,-10,10,"2018-19",53.4883720930233
"2930",2018-11-28,"Dallas Mavericks",128,"Houston Rockets",108,18055,0,-20,20,"2018-19",76.5957446808511
"2931",2018-11-28,"Chicago Bulls",113,"Milwaukee Bucks",116,16660,1,3,3,"2018-19",79.5918367346939
"2932",2018-11-28,"San Antonio Spurs",89,"Minnesota Timberwolves",128,11023,1,39,39,"2018-19",60.9756097560976
"2933",2018-11-28,"Washington Wizards",104,"New Orleans Pelicans",125,13570,1,21,21,"2018-19",46.3414634146341
"2934",2018-11-28,"Cleveland Cavaliers",83,"Oklahoma City Thunder",100,18203,1,17,17,"2018-19",65.1162790697674
"2935",2018-11-28,"Orlando Magic",112,"Portland Trail Blazers",115,18865,1,3,3,"2018-19",75.5102040816327
"2936",2018-11-28,"Phoenix Suns",99,"Los Angeles Clippers",115,16372,1,16,16,"2018-19",59.0909090909091
"2937",2018-11-29,"Golden State Warriors",128,"Toronto Raptors",131,20073,1,3,3,"2018-19",75.9259259259259
"2938",2018-11-29,"Indiana Pacers",96,"Los Angeles Lakers",104,18997,1,8,8,"2018-19",53.6585365853659
"2939",2018-11-29,"Los Angeles Clippers",133,"Sacramento Kings",121,17583,0,-12,12,"2018-19",58.5365853658537
"2940",2018-11-30,"Cleveland Cavaliers",95,"Boston Celtics",128,18624,1,33,33,"2018-19",66.6666666666667
"2941",2018-11-30,"Utah Jazz",119,"Charlotte Hornets",111,15812,0,-8,8,"2018-19",60.9756097560976
"2942",2018-11-30,"Chicago Bulls",88,"Detroit Pistons",107,15372,1,19,19,"2018-19",60.4651162790698
"2943",2018-11-30,"Washington Wizards",98,"Philadelphia 76ers",123,20400,1,25,25,"2018-19",74.468085106383
"2944",2018-11-30,"Memphis Grizzlies",131,"Brooklyn Nets",125,12983,0,-6,6,"2018-19",53.4883720930233
"2945",2018-11-30,"New Orleans Pelicans",101,"Miami Heat",106,19600,1,5,5,"2018-19",46.3414634146341
"2946",2018-11-30,"Atlanta Hawks",109,"Oklahoma City Thunder",124,18203,1,15,15,"2018-19",65.1162790697674
"2947",2018-11-30,"Houston Rockets",136,"San Antonio Spurs",105,18354,0,-31,31,"2018-19",77.2727272727273
"2948",2018-11-30,"Orlando Magic",99,"Phoenix Suns",85,13228,0,-14,14,"2018-19",29.2682926829268
"2949",2018-11-30,"Dallas Mavericks",103,"Los Angeles Lakers",114,18997,1,11,11,"2018-19",53.6585365853659
"2950",2018-11-30,"Denver Nuggets",113,"Portland Trail Blazers",112,19459,0,-1,1,"2018-19",75.5102040816327
"2951",2018-12-01,"Milwaukee Bucks",134,"New York Knicks",136,19812,1,2,2,"2018-19",21.9512195121951
"2952",2018-12-01,"Golden State Warriors",102,"Detroit Pistons",111,20332,1,9,9,"2018-19",60.4651162790698
"2953",2018-12-01,"Brooklyn Nets",88,"Washington Wizards",102,15448,1,14,14,"2018-19",53.6585365853659
"2954",2018-12-01,"Toronto Raptors",106,"Cleveland Cavaliers",95,19432,0,-11,11,"2018-19",31.7073170731707
"2955",2018-12-01,"Chicago Bulls",105,"Houston Rockets",121,18055,1,16,16,"2018-19",76.5957446808511
"2956",2018-12-01,"Boston Celtics",118,"Minnesota Timberwolves",109,17663,0,-9,9,"2018-19",60.9756097560976
"2957",2018-12-01,"Indiana Pacers",110,"Sacramento Kings",111,17583,1,1,1,"2018-19",58.5365853658537
"2958",2018-12-02,"Phoenix Suns",96,"Los Angeles Lakers",120,18997,1,24,24,"2018-19",53.6585365853659
"2959",2018-12-02,"New Orleans Pelicans",119,"Charlotte Hornets",109,15336,0,-10,10,"2018-19",60.9756097560976
"2960",2018-12-02,"Utah Jazz",100,"Miami Heat",102,19600,1,2,2,"2018-19",46.3414634146341
"2961",2018-12-02,"Memphis Grizzlies",95,"Philadelphia 76ers",103,20334,1,8,8,"2018-19",74.468085106383
"2962",2018-12-02,"Los Angeles Clippers",110,"Dallas Mavericks",114,19551,1,4,4,"2018-19",58.5365853658537
"2963",2018-12-02,"Portland Trail Blazers",118,"San Antonio Spurs",131,18354,1,13,13,"2018-19",77.2727272727273
"2964",2018-12-03,"Oklahoma City Thunder",110,"Detroit Pistons",83,14372,0,-27,27,"2018-19",60.4651162790698
"2965",2018-12-03,"Golden State Warriors",128,"Atlanta Hawks",111,16631,0,-17,17,"2018-19",41.4634146341463
"2966",2018-12-03,"Cleveland Cavaliers",99,"Brooklyn Nets",97,10983,0,-2,2,"2018-19",53.4883720930233
"2967",2018-12-03,"Washington Wizards",110,"New York Knicks",107,19440,0,-3,3,"2018-19",21.9512195121951
"2968",2018-12-03,"Denver Nuggets",106,"Toronto Raptors",103,19800,0,-3,3,"2018-19",75.9259259259259
"2969",2018-12-03,"Houston Rockets",91,"Minnesota Timberwolves",103,13834,1,12,12,"2018-19",60.9756097560976
"2970",2018-12-03,"Los Angeles Clippers",129,"New Orleans Pelicans",126,13822,0,-3,3,"2018-19",46.3414634146341
"2971",2018-12-04,"Chicago Bulls",90,"Indiana Pacers",96,16446,1,6,6,"2018-19",67.4418604651163
"2972",2018-12-04,"Orlando Magic",105,"Miami Heat",90,19600,0,-15,15,"2018-19",46.3414634146341
"2973",2018-12-04,"Portland Trail Blazers",102,"Dallas Mavericks",111,19341,1,9,9,"2018-19",58.5365853658537
"2974",2018-12-04,"Sacramento Kings",122,"Phoenix Suns",105,12977,0,-17,17,"2018-19",29.2682926829268
"2975",2018-12-04,"San Antonio Spurs",105,"Utah Jazz",139,18306,1,34,34,"2018-19",69.7674418604651
"2976",2018-12-05,"Golden State Warriors",129,"Cleveland Cavaliers",105,19432,0,-24,24,"2018-19",31.7073170731707
"2977",2018-12-05,"Denver Nuggets",124,"Orlando Magic",118,16636,0,-6,6,"2018-19",58.1395348837209
"2978",2018-12-05,"Washington Wizards",131,"Atlanta Hawks",117,12551,0,-14,14,"2018-19",41.4634146341463
"2979",2018-12-05,"Oklahoma City Thunder",114,"Brooklyn Nets",112,13161,0,-2,2,"2018-19",53.4883720930233
"2980",2018-12-05,"Los Angeles Clippers",86,"Memphis Grizzlies",96,14144,1,10,10,"2018-19",51.219512195122
"2981",2018-12-05,"Detroit Pistons",92,"Milwaukee Bucks",115,16541,1,23,23,"2018-19",79.5918367346939
"2982",2018-12-05,"Charlotte Hornets",104,"Minnesota Timberwolves",121,11248,1,17,17,"2018-19",60.9756097560976
"2983",2018-12-05,"Dallas Mavericks",106,"New Orleans Pelicans",132,14810,1,26,26,"2018-19",46.3414634146341
"2984",2018-12-05,"Philadelphia 76ers",102,"Toronto Raptors",113,19800,1,11,11,"2018-19",75.9259259259259
"2985",2018-12-05,"San Antonio Spurs",113,"Los Angeles Lakers",121,18997,1,8,8,"2018-19",53.6585365853659
"2986",2018-12-06,"New York Knicks",100,"Boston Celtics",128,18624,1,28,28,"2018-19",66.6666666666667
"2987",2018-12-06,"Phoenix Suns",86,"Portland Trail Blazers",108,19001,1,22,22,"2018-19",75.5102040816327
"2988",2018-12-06,"Houston Rockets",91,"Utah Jazz",118,18306,1,27,27,"2018-19",69.7674418604651
"2989",2018-12-07,"Denver Nuggets",107,"Charlotte Hornets",113,13755,1,6,6,"2018-19",60.9756097560976
"2990",2018-12-07,"Philadelphia 76ers",117,"Detroit Pistons",111,15680,0,-6,6,"2018-19",60.4651162790698
"2991",2018-12-07,"Indiana Pacers",112,"Orlando Magic",90,17214,0,-22,22,"2018-19",58.1395348837209
"2992",2018-12-07,"Toronto Raptors",105,"Brooklyn Nets",106,14035,1,1,1,"2018-19",53.4883720930233
"2993",2018-12-07,"Sacramento Kings",129,"Cleveland Cavaliers",110,19432,0,-19,19,"2018-19",31.7073170731707
"2994",2018-12-07,"Oklahoma City Thunder",112,"Chicago Bulls",114,19842,1,2,2,"2018-19",21.9512195121951
"2995",2018-12-07,"Memphis Grizzlies",107,"New Orleans Pelicans",103,18447,0,-4,4,"2018-19",46.3414634146341
"2996",2018-12-07,"Los Angeles Lakers",120,"San Antonio Spurs",133,18354,1,13,13,"2018-19",77.2727272727273
"2997",2018-12-07,"Miami Heat",115,"Phoenix Suns",98,14273,0,-17,17,"2018-19",29.2682926829268
"2998",2018-12-07,"Golden State Warriors",105,"Milwaukee Bucks",95,17852,0,-10,10,"2018-19",79.5918367346939
"2999",2018-12-08,"Houston Rockets",104,"Dallas Mavericks",107,20254,1,3,3,"2018-19",58.5365853658537
"3000",2018-12-08,"Sacramento Kings",97,"Indiana Pacers",107,16867,1,10,10,"2018-19",67.4418604651163
"3001",2018-12-08,"Denver Nuggets",98,"Atlanta Hawks",106,14409,1,8,8,"2018-19",41.4634146341463
"3002",2018-12-08,"Washington Wizards",101,"Cleveland Cavaliers",116,19432,1,15,15,"2018-19",31.7073170731707
"3003",2018-12-08,"Brooklyn Nets",112,"New York Knicks",104,18662,0,-8,8,"2018-19",21.9512195121951
"3004",2018-12-08,"Boston Celtics",133,"Chicago Bulls",77,20923,0,-56,56,"2018-19",21.9512195121951
"3005",2018-12-08,"Los Angeles Lakers",111,"Memphis Grizzlies",88,17794,0,-23,23,"2018-19",51.219512195122
"3006",2018-12-08,"Minnesota Timberwolves",105,"Portland Trail Blazers",113,19359,1,8,8,"2018-19",75.5102040816327
"3007",2018-12-08,"Miami Heat",121,"Los Angeles Clippers",98,17113,0,-23,23,"2018-19",59.0909090909091
"3008",2018-12-09,"New Orleans Pelicans",116,"Detroit Pistons",108,14705,0,-8,8,"2018-19",60.4651162790698
"3009",2018-12-09,"Milwaukee Bucks",104,"Toronto Raptors",99,19800,0,-5,5,"2018-19",75.9259259259259
"3010",2018-12-09,"Utah Jazz",97,"San Antonio Spurs",110,17834,1,13,13,"2018-19",77.2727272727273
"3011",2018-12-09,"Charlotte Hornets",119,"New York Knicks",107,18602,0,-12,12,"2018-19",21.9512195121951
"3012",2018-12-10,"Washington Wizards",101,"Indiana Pacers",109,14645,1,8,8,"2018-19",67.4418604651163
"3013",2018-12-10,"Detroit Pistons",102,"Philadelphia 76ers",116,20199,1,14,14,"2018-19",74.468085106383
"3014",2018-12-10,"New Orleans Pelicans",100,"Boston Celtics",113,18624,1,13,13,"2018-19",66.6666666666667
"3015",2018-12-10,"Sacramento Kings",108,"Chicago Bulls",89,18164,0,-19,19,"2018-19",21.9512195121951
"3016",2018-12-10,"Cleveland Cavaliers",92,"Milwaukee Bucks",108,17155,1,16,16,"2018-19",79.5918367346939
"3017",2018-12-10,"Utah Jazz",113,"Oklahoma City Thunder",122,18203,1,9,9,"2018-19",65.1162790697674
"3018",2018-12-10,"Orlando Magic",76,"Dallas Mavericks",101,19334,1,25,25,"2018-19",58.5365853658537
"3019",2018-12-10,"Memphis Grizzlies",99,"Denver Nuggets",105,15278,1,6,6,"2018-19",79.5918367346939
"3020",2018-12-10,"Los Angeles Clippers",123,"Phoenix Suns",119,12088,0,-4,4,"2018-19",29.2682926829268
"3021",2018-12-10,"Minnesota Timberwolves",108,"Golden State Warriors",116,19596,1,8,8,"2018-19",69.2307692307692
"3022",2018-12-10,"Miami Heat",105,"Los Angeles Lakers",108,18997,1,3,3,"2018-19",53.6585365853659
"3023",2018-12-11,"Portland Trail Blazers",104,"Houston Rockets",111,18055,1,7,7,"2018-19",76.5957446808511
"3024",2018-12-11,"Phoenix Suns",86,"San Antonio Spurs",111,17676,1,25,25,"2018-19",77.2727272727273
"3025",2018-12-11,"Toronto Raptors",123,"Los Angeles Clippers",99,17812,0,-24,24,"2018-19",59.0909090909091
"3026",2018-12-12,"Detroit Pistons",107,"Charlotte Hornets",108,13997,1,1,1,"2018-19",60.9756097560976
"3027",2018-12-12,"New York Knicks",106,"Cleveland Cavaliers",113,19432,1,7,7,"2018-19",31.7073170731707
"3028",2018-12-12,"Milwaukee Bucks",97,"Indiana Pacers",113,17070,1,16,16,"2018-19",67.4418604651163
"3029",2018-12-12,"Brooklyn Nets",127,"Philadelphia 76ers",124,20376,0,-3,3,"2018-19",74.468085106383
"3030",2018-12-12,"Boston Celtics",130,"Washington Wizards",125,20409,0,-5,5,"2018-19",53.6585365853659
"3031",2018-12-12,"Portland Trail Blazers",83,"Memphis Grizzlies",92,16282,1,9,9,"2018-19",51.219512195122
"3032",2018-12-12,"Oklahoma City Thunder",114,"New Orleans Pelicans",118,14450,1,4,4,"2018-19",46.3414634146341
"3033",2018-12-12,"Atlanta Hawks",107,"Dallas Mavericks",114,19643,1,7,7,"2018-19",58.5365853658537
"3034",2018-12-12,"Miami Heat",84,"Utah Jazz",111,18306,1,27,27,"2018-19",69.7674418604651
"3035",2018-12-12,"Minnesota Timberwolves",130,"Sacramento Kings",141,15770,1,11,11,"2018-19",58.5365853658537
"3036",2018-12-12,"Toronto Raptors",113,"Golden State Warriors",93,19596,0,-20,20,"2018-19",69.2307692307692
"3037",2018-12-13,"Los Angeles Lakers",111,"Houston Rockets",126,18055,1,15,15,"2018-19",76.5957446808511
"3038",2018-12-13,"Los Angeles Clippers",87,"San Antonio Spurs",125,18354,1,38,38,"2018-19",77.2727272727273
"3039",2018-12-13,"Chicago Bulls",91,"Orlando Magic",97,20201,1,6,6,"2018-19",58.1395348837209
"3040",2018-12-13,"Dallas Mavericks",89,"Phoenix Suns",99,13265,1,10,10,"2018-19",29.2682926829268
"3041",2018-12-14,"Atlanta Hawks",108,"Boston Celtics",129,18624,1,21,21,"2018-19",66.6666666666667
"3042",2018-12-14,"New York Knicks",126,"Charlotte Hornets",124,17622,0,-2,2,"2018-19",60.9756097560976
"3043",2018-12-14,"Washington Wizards",118,"Brooklyn Nets",125,13232,1,7,7,"2018-19",53.4883720930233
"3044",2018-12-14,"Milwaukee Bucks",114,"Cleveland Cavaliers",102,19432,0,-12,12,"2018-19",31.7073170731707
"3045",2018-12-14,"Indiana Pacers",113,"Philadelphia 76ers",101,20337,0,-12,12,"2018-19",74.468085106383
"3046",2018-12-14,"Miami Heat",100,"Memphis Grizzlies",97,16313,0,-3,3,"2018-19",51.219512195122
"3047",2018-12-14,"Oklahoma City Thunder",98,"Denver Nuggets",109,19520,1,11,11,"2018-19",79.5918367346939
"3048",2018-12-14,"Toronto Raptors",122,"Portland Trail Blazers",128,19458,1,6,6,"2018-19",75.5102040816327
"3049",2018-12-14,"Golden State Warriors",130,"Sacramento Kings",125,17583,0,-5,5,"2018-19",58.5365853658537
"3050",2018-12-15,"Utah Jazz",89,"Orlando Magic",96,20011,1,7,7,"2018-19",58.1395348837209
"3051",2018-12-15,"Los Angeles Lakers",128,"Charlotte Hornets",100,19641,0,-28,28,"2018-19",60.9756097560976
"3052",2018-12-15,"Boston Celtics",104,"Detroit Pistons",113,17078,1,9,9,"2018-19",60.4651162790698
"3053",2018-12-15,"Houston Rockets",105,"Memphis Grizzlies",97,16777,0,-8,8,"2018-19",51.219512195122
"3054",2018-12-15,"Chicago Bulls",98,"San Antonio Spurs",93,18354,0,-5,5,"2018-19",77.2727272727273
"3055",2018-12-15,"Los Angeles Clippers",104,"Oklahoma City Thunder",110,18203,1,6,6,"2018-19",65.1162790697674
"3056",2018-12-15,"Minnesota Timberwolves",99,"Phoenix Suns",107,14244,1,8,8,"2018-19",29.2682926829268
"3057",2018-12-16,"Atlanta Hawks",127,"Brooklyn Nets",144,13955,1,17,17,"2018-19",53.4883720930233
"3058",2018-12-16,"Philadelphia 76ers",128,"Cleveland Cavaliers",105,19432,0,-23,23,"2018-19",31.7073170731707
"3059",2018-12-16,"New York Knicks",99,"Indiana Pacers",110,16646,1,11,11,"2018-19",67.4418604651163
"3060",2018-12-16,"Los Angeles Lakers",110,"Washington Wizards",128,20409,1,18,18,"2018-19",53.6585365853659
"3061",2018-12-16,"Sacramento Kings",120,"Dallas Mavericks",113,19935,0,-7,7,"2018-19",58.5365853658537
"3062",2018-12-16,"Miami Heat",102,"New Orleans Pelicans",96,15535,0,-6,6,"2018-19",46.3414634146341
"3063",2018-12-16,"Toronto Raptors",86,"Denver Nuggets",95,19520,1,9,9,"2018-19",79.5918367346939
"3064",2018-12-17,"Milwaukee Bucks",107,"Detroit Pistons",104,15051,0,-3,3,"2018-19",60.4651162790698
"3065",2018-12-17,"Phoenix Suns",128,"New York Knicks",110,18437,0,-18,18,"2018-19",21.9512195121951
"3066",2018-12-17,"Utah Jazz",97,"Houston Rockets",102,18055,1,5,5,"2018-19",76.5957446808511
"3067",2018-12-17,"Sacramento Kings",105,"Minnesota Timberwolves",132,12417,1,27,27,"2018-19",60.9756097560976
"3068",2018-12-17,"Chicago Bulls",96,"Oklahoma City Thunder",121,18203,1,25,25,"2018-19",65.1162790697674
"3069",2018-12-17,"Philadelphia 76ers",96,"San Antonio Spurs",123,17486,1,27,27,"2018-19",77.2727272727273
"3070",2018-12-17,"Memphis Grizzlies",93,"Golden State Warriors",110,19596,1,17,17,"2018-19",69.2307692307692
"3071",2018-12-17,"Portland Trail Blazers",131,"Los Angeles Clippers",127,16030,0,-4,4,"2018-19",59.0909090909091
"3072",2018-12-18,"Cleveland Cavaliers",92,"Indiana Pacers",91,15630,0,-1,1,"2018-19",67.4418604651163
"3073",2018-12-18,"Washington Wizards",110,"Atlanta Hawks",118,16489,1,8,8,"2018-19",41.4634146341463
"3074",2018-12-18,"Los Angeles Lakers",110,"Brooklyn Nets",115,17732,1,5,5,"2018-19",53.4883720930233
"3075",2018-12-18,"Dallas Mavericks",118,"Denver Nuggets",126,15764,1,8,8,"2018-19",79.5918367346939
"3076",2018-12-19,"Cleveland Cavaliers",99,"Charlotte Hornets",110,15179,1,11,11,"2018-19",60.9756097560976
"3077",2018-12-19,"San Antonio Spurs",129,"Orlando Magic",90,17138,0,-39,39,"2018-19",58.1395348837209
"3078",2018-12-19,"New York Knicks",109,"Philadelphia 76ers",131,20424,1,22,22,"2018-19",74.468085106383
"3079",2018-12-19,"Phoenix Suns",111,"Boston Celtics",103,18624,0,-8,8,"2018-19",66.6666666666667
"3080",2018-12-19,"Indiana Pacers",96,"Toronto Raptors",99,19800,1,3,3,"2018-19",75.9259259259259
"3081",2018-12-19,"Brooklyn Nets",96,"Chicago Bulls",93,18065,0,-3,3,"2018-19",21.9512195121951
"3082",2018-12-19,"Washington Wizards",118,"Houston Rockets",136,18055,1,18,18,"2018-19",76.5957446808511
"3083",2018-12-19,"New Orleans Pelicans",115,"Milwaukee Bucks",123,17341,1,8,8,"2018-19",79.5918367346939
"3084",2018-12-19,"Detroit Pistons",129,"Minnesota Timberwolves",123,15883,0,-6,6,"2018-19",60.9756097560976
"3085",2018-12-19,"Golden State Warriors",103,"Utah Jazz",108,18306,1,5,5,"2018-19",69.7674418604651
"3086",2018-12-19,"Memphis Grizzlies",92,"Portland Trail Blazers",99,19412,1,7,7,"2018-19",75.5102040816327
"3087",2018-12-19,"Oklahoma City Thunder",132,"Sacramento Kings",113,17583,0,-19,19,"2018-19",58.5365853658537
"3088",2018-12-20,"Houston Rockets",99,"Miami Heat",101,19600,1,2,2,"2018-19",46.3414634146341
"3089",2018-12-20,"Dallas Mavericks",121,"Los Angeles Clippers",125,17528,1,4,4,"2018-19",59.0909090909091
"3090",2018-12-21,"Detroit Pistons",86,"Charlotte Hornets",98,15812,1,12,12,"2018-19",60.9756097560976
"3091",2018-12-21,"Cleveland Cavaliers",110,"Toronto Raptors",126,19800,1,16,16,"2018-19",75.9259259259259
"3092",2018-12-21,"Indiana Pacers",114,"Brooklyn Nets",106,13302,0,-8,8,"2018-19",53.4883720930233
"3093",2018-12-21,"Atlanta Hawks",114,"New York Knicks",107,19080,0,-7,7,"2018-19",21.9512195121951
"3094",2018-12-21,"Milwaukee Bucks",120,"Boston Celtics",107,18624,0,-13,13,"2018-19",66.6666666666667
"3095",2018-12-21,"Orlando Magic",80,"Chicago Bulls",90,20436,1,10,10,"2018-19",21.9512195121951
"3096",2018-12-21,"Minnesota Timberwolves",98,"San Antonio Spurs",124,17708,1,26,26,"2018-19",77.2727272727273
"3097",2018-12-21,"Utah Jazz",120,"Portland Trail Blazers",90,19127,0,-30,30,"2018-19",75.5102040816327
"3098",2018-12-21,"Memphis Grizzlies",99,"Sacramento Kings",102,16369,1,3,3,"2018-19",58.5365853658537
"3099",2018-12-21,"New Orleans Pelicans",104,"Los Angeles Lakers",112,18997,1,8,8,"2018-19",53.6585365853659
"3100",2018-12-22,"Denver Nuggets",111,"Los Angeles Clippers",132,16571,1,21,21,"2018-19",59.0909090909091
"3101",2018-12-22,"Phoenix Suns",146,"Washington Wizards",149,16571,1,3,3,"2018-19",53.6585365853659
"3102",2018-12-22,"Toronto Raptors",101,"Philadelphia 76ers",126,20691,1,25,25,"2018-19",74.468085106383
"3103",2018-12-22,"San Antonio Spurs",101,"Houston Rockets",108,18055,1,7,7,"2018-19",76.5957446808511
"3104",2018-12-22,"Milwaukee Bucks",87,"Miami Heat",94,19600,1,7,7,"2018-19",46.3414634146341
"3105",2018-12-22,"Dallas Mavericks",116,"Golden State Warriors",120,19596,1,4,4,"2018-19",69.2307692307692
"3106",2018-12-22,"Oklahoma City Thunder",107,"Utah Jazz",106,18306,0,-1,1,"2018-19",69.7674418604651
"3107",2018-12-23,"Atlanta Hawks",98,"Detroit Pistons",95,16532,0,-3,3,"2018-19",60.4651162790698
"3108",2018-12-23,"Washington Wizards",89,"Indiana Pacers",105,17923,1,16,16,"2018-19",67.4418604651163
"3109",2018-12-23,"Charlotte Hornets",103,"Boston Celtics",119,18624,1,16,16,"2018-19",66.6666666666667
"3110",2018-12-23,"Phoenix Suns",103,"Brooklyn Nets",111,15310,1,8,8,"2018-19",53.4883720930233
"3111",2018-12-23,"Chicago Bulls",112,"Cleveland Cavaliers",92,19432,0,-20,20,"2018-19",31.7073170731707
"3112",2018-12-23,"Miami Heat",115,"Orlando Magic",91,18846,0,-24,24,"2018-19",58.1395348837209
"3113",2018-12-23,"New Orleans Pelicans",117,"Sacramento Kings",122,16643,1,5,5,"2018-19",58.5365853658537
"3114",2018-12-23,"Minnesota Timberwolves",114,"Oklahoma City Thunder",112,18203,0,-2,2,"2018-19",65.1162790697674
"3115",2018-12-23,"Los Angeles Clippers",127,"Golden State Warriors",129,19596,1,2,2,"2018-19",69.2307692307692
"3116",2018-12-23,"Dallas Mavericks",118,"Portland Trail Blazers",121,19707,1,3,3,"2018-19",75.5102040816327
"3117",2018-12-23,"Memphis Grizzlies",107,"Los Angeles Lakers",99,18997,0,-8,8,"2018-19",53.6585365853659
"3118",2018-12-25,"Milwaukee Bucks",109,"New York Knicks",95,19812,0,-14,14,"2018-19",21.9512195121951
"3119",2018-12-25,"Oklahoma City Thunder",109,"Houston Rockets",113,18055,1,4,4,"2018-19",76.5957446808511
"3120",2018-12-25,"Philadelphia 76ers",114,"Boston Celtics",121,18624,1,7,7,"2018-19",66.6666666666667
"3121",2018-12-25,"Los Angeles Lakers",127,"Golden State Warriors",101,19596,0,-26,26,"2018-19",69.2307692307692
"3122",2018-12-25,"Portland Trail Blazers",96,"Utah Jazz",117,18306,1,21,21,"2018-19",69.7674418604651
"3123",2018-12-26,"Washington Wizards",95,"Detroit Pistons",106,17534,1,11,11,"2018-19",60.4651162790698
"3124",2018-12-26,"Phoenix Suns",122,"Orlando Magic",120,16755,0,-2,2,"2018-19",58.1395348837209
"3125",2018-12-26,"Indiana Pacers",129,"Atlanta Hawks",121,15026,0,-8,8,"2018-19",41.4634146341463
"3126",2018-12-26,"Charlotte Hornets",132,"Brooklyn Nets",134,14309,1,2,2,"2018-19",53.4883720930233
"3127",2018-12-26,"Toronto Raptors",106,"Miami Heat",104,19902,0,-2,2,"2018-19",46.3414634146341
"3128",2018-12-26,"Minnesota Timberwolves",119,"Chicago Bulls",94,21852,0,-25,25,"2018-19",21.9512195121951
"3129",2018-12-26,"Cleveland Cavaliers",87,"Memphis Grizzlies",95,16424,1,8,8,"2018-19",51.219512195122
"3130",2018-12-26,"New Orleans Pelicans",119,"Dallas Mavericks",122,20340,1,3,3,"2018-19",58.5365853658537
"3131",2018-12-26,"Denver Nuggets",103,"San Antonio Spurs",111,18408,1,8,8,"2018-19",77.2727272727273
"3132",2018-12-26,"Sacramento Kings",118,"Los Angeles Clippers",127,19068,1,9,9,"2018-19",59.0909090909091
"3133",2018-12-27,"Boston Celtics",113,"Houston Rockets",127,18055,1,14,14,"2018-19",76.5957446808511
"3134",2018-12-27,"New York Knicks",96,"Milwaukee Bucks",112,18058,1,16,16,"2018-19",79.5918367346939
"3135",2018-12-27,"Los Angeles Lakers",116,"Sacramento Kings",117,17583,1,1,1,"2018-19",58.5365853658537
"3136",2018-12-27,"Portland Trail Blazers",110,"Golden State Warriors",109,19596,0,-1,1,"2018-19",69.2307692307692
"3137",2018-12-27,"Philadelphia 76ers",114,"Utah Jazz",97,18306,0,-17,17,"2018-19",69.7674418604651
"3138",2018-12-28,"Brooklyn Nets",87,"Charlotte Hornets",100,19411,1,13,13,"2018-19",60.9756097560976
"3139",2018-12-28,"Detroit Pistons",88,"Indiana Pacers",125,17923,1,37,37,"2018-19",67.4418604651163
"3140",2018-12-28,"Toronto Raptors",87,"Orlando Magic",116,18846,1,29,29,"2018-19",58.1395348837209
"3141",2018-12-28,"Chicago Bulls",101,"Washington Wizards",92,20409,0,-9,9,"2018-19",53.6585365853659
"3142",2018-12-28,"Cleveland Cavaliers",94,"Miami Heat",118,19617,1,24,24,"2018-19",46.3414634146341
"3143",2018-12-28,"Atlanta Hawks",123,"Minnesota Timberwolves",120,18978,0,-3,3,"2018-19",60.9756097560976
"3144",2018-12-28,"Dallas Mavericks",112,"New Orleans Pelicans",114,18364,1,2,2,"2018-19",46.3414634146341
"3145",2018-12-28,"San Antonio Spurs",99,"Denver Nuggets",102,20076,1,3,3,"2018-19",79.5918367346939
"3146",2018-12-28,"Oklahoma City Thunder",118,"Phoenix Suns",102,18055,0,-16,16,"2018-19",29.2682926829268
"3147",2018-12-28,"Los Angeles Clippers",118,"Los Angeles Lakers",107,18997,0,-11,11,"2018-19",53.6585365853659
"3148",2018-12-29,"Brooklyn Nets",115,"Milwaukee Bucks",129,17918,1,14,14,"2018-19",79.5918367346939
"3149",2018-12-29,"Houston Rockets",108,"New Orleans Pelicans",104,17555,0,-4,4,"2018-19",46.3414634146341
"3150",2018-12-29,"Charlotte Hornets",126,"Washington Wizards",130,17197,1,4,4,"2018-19",53.6585365853659
"3151",2018-12-29,"Cleveland Cavaliers",108,"Atlanta Hawks",111,16460,1,3,3,"2018-19",41.4634146341463
"3152",2018-12-29,"Boston Celtics",112,"Memphis Grizzlies",103,17794,0,-9,9,"2018-19",51.219512195122
"3153",2018-12-29,"New York Knicks",97,"Utah Jazz",129,18306,1,32,32,"2018-19",69.7674418604651
"3154",2018-12-29,"Denver Nuggets",122,"Phoenix Suns",118,14975,0,-4,4,"2018-19",29.2682926829268
"3155",2018-12-29,"Golden State Warriors",115,"Portland Trail Blazers",105,19797,0,-10,10,"2018-19",75.5102040816327
"3156",2018-12-29,"San Antonio Spurs",122,"Los Angeles Clippers",111,19068,0,-11,11,"2018-19",59.0909090909091
"3157",2018-12-30,"Detroit Pistons",107,"Orlando Magic",109,17761,1,2,2,"2018-19",58.1395348837209
"3158",2018-12-30,"Minnesota Timberwolves",113,"Miami Heat",104,19600,0,-9,9,"2018-19",46.3414634146341
"3159",2018-12-30,"Chicago Bulls",89,"Toronto Raptors",95,19800,1,6,6,"2018-19",75.9259259259259
"3160",2018-12-30,"Oklahoma City Thunder",103,"Dallas Mavericks",105,20380,1,2,2,"2018-19",58.5365853658537
"3161",2018-12-30,"Philadelphia 76ers",95,"Portland Trail Blazers",129,19393,1,34,34,"2018-19",75.5102040816327
"3162",2018-12-30,"Sacramento Kings",114,"Los Angeles Lakers",121,18997,1,7,7,"2018-19",53.6585365853659
"3163",2018-12-31,"Atlanta Hawks",108,"Indiana Pacers",116,17923,1,8,8,"2018-19",67.4418604651163
"3164",2018-12-31,"Orlando Magic",100,"Charlotte Hornets",125,14694,1,25,25,"2018-19",60.9756097560976
"3165",2018-12-31,"Memphis Grizzlies",101,"Houston Rockets",113,18055,1,12,12,"2018-19",76.5957446808511
"3166",2018-12-31,"Boston Celtics",111,"San Antonio Spurs",120,18354,1,9,9,"2018-19",77.2727272727273
"3167",2018-12-31,"Minnesota Timberwolves",114,"New Orleans Pelicans",123,14904,1,9,9,"2018-19",46.3414634146341
"3168",2018-12-31,"Dallas Mavericks",102,"Oklahoma City Thunder",122,18203,1,20,20,"2018-19",65.1162790697674
"3169",2018-12-31,"Golden State Warriors",132,"Phoenix Suns",109,16906,0,-23,23,"2018-19",29.2682926829268
"3170",2019-01-01,"Utah Jazz",116,"Toronto Raptors",122,19800,1,6,6,"2018-19",75.9259259259259
"3171",2019-01-01,"Detroit Pistons",98,"Milwaukee Bucks",121,17534,1,23,23,"2018-19",79.5918367346939
"3172",2019-01-01,"New York Knicks",108,"Denver Nuggets",115,19520,1,7,7,"2018-19",79.5918367346939
"3173",2019-01-01,"Portland Trail Blazers",113,"Sacramento Kings",108,17583,0,-5,5,"2018-19",58.5365853658537
"3174",2019-01-01,"Philadelphia 76ers",119,"Los Angeles Clippers",113,17868,0,-6,6,"2018-19",59.0909090909091
"3175",2019-01-02,"Dallas Mavericks",122,"Charlotte Hornets",84,16955,0,-38,38,"2018-19",60.9756097560976
"3176",2019-01-02,"Miami Heat",117,"Cleveland Cavaliers",92,19432,0,-25,25,"2018-19",31.7073170731707
"3177",2019-01-02,"Atlanta Hawks",98,"Washington Wizards",114,15324,1,16,16,"2018-19",53.6585365853659
"3178",2019-01-02,"New Orleans Pelicans",121,"Brooklyn Nets",126,16890,1,5,5,"2018-19",53.4883720930233
"3179",2019-01-02,"Minnesota Timberwolves",102,"Boston Celtics",115,18624,1,13,13,"2018-19",66.6666666666667
"3180",2019-01-02,"Orlando Magic",112,"Chicago Bulls",84,19013,0,-28,28,"2018-19",21.9512195121951
"3181",2019-01-02,"Detroit Pistons",101,"Memphis Grizzlies",94,14109,0,-7,7,"2018-19",51.219512195122
"3182",2019-01-02,"Philadelphia 76ers",132,"Phoenix Suns",127,15226,0,-5,5,"2018-19",29.2682926829268
"3183",2019-01-02,"Oklahoma City Thunder",107,"Los Angeles Lakers",100,18997,0,-7,7,"2018-19",53.6585365853659
"3184",2019-01-03,"Toronto Raptors",107,"San Antonio Spurs",125,18354,1,18,18,"2018-19",77.2727272727273
"3185",2019-01-03,"Denver Nuggets",117,"Sacramento Kings",113,17583,0,-4,4,"2018-19",58.5365853658537
"3186",2019-01-03,"Houston Rockets",135,"Golden State Warriors",134,19596,0,-1,1,"2018-19",69.2307692307692
"3187",2019-01-04,"Utah Jazz",117,"Cleveland Cavaliers",91,19432,0,-26,26,"2018-19",31.7073170731707
"3188",2019-01-04,"Dallas Mavericks",93,"Boston Celtics",114,18624,1,21,21,"2018-19",66.6666666666667
"3189",2019-01-04,"Indiana Pacers",119,"Chicago Bulls",116,21284,0,-3,3,"2018-19",21.9512195121951
"3190",2019-01-04,"Brooklyn Nets",109,"Memphis Grizzlies",100,16683,0,-9,9,"2018-19",51.219512195122
"3191",2019-01-04,"Washington Wizards",109,"Miami Heat",115,19600,1,6,6,"2018-19",46.3414634146341
"3192",2019-01-04,"Orlando Magic",103,"Minnesota Timberwolves",120,14355,1,17,17,"2018-19",60.9756097560976
"3193",2019-01-04,"Atlanta Hawks",112,"Milwaukee Bucks",144,17632,1,32,32,"2018-19",79.5918367346939
"3194",2019-01-04,"Los Angeles Clippers",121,"Phoenix Suns",111,14764,0,-10,10,"2018-19",29.2682926829268
"3195",2019-01-04,"New York Knicks",119,"Los Angeles Lakers",112,18997,0,-7,7,"2018-19",53.6585365853659
"3196",2019-01-04,"Oklahoma City Thunder",111,"Portland Trail Blazers",109,19393,0,-2,2,"2018-19",75.5102040816327
"3197",2019-01-05,"Charlotte Hornets",110,"Denver Nuggets",123,19861,1,13,13,"2018-19",79.5918367346939
"3198",2019-01-05,"Utah Jazz",110,"Detroit Pistons",105,17255,0,-5,5,"2018-19",60.4651162790698
"3199",2019-01-05,"Dallas Mavericks",100,"Philadelphia 76ers",106,20656,1,6,6,"2018-19",74.468085106383
"3200",2019-01-05,"New Orleans Pelicans",133,"Cleveland Cavaliers",98,19432,0,-35,35,"2018-19",31.7073170731707
"3201",2019-01-05,"Toronto Raptors",123,"Milwaukee Bucks",116,18028,0,-7,7,"2018-19",79.5918367346939
"3202",2019-01-05,"Memphis Grizzlies",88,"San Antonio Spurs",108,18354,1,20,20,"2018-19",77.2727272727273
"3203",2019-01-05,"Houston Rockets",101,"Portland Trail Blazers",110,19577,1,9,9,"2018-19",75.5102040816327
"3204",2019-01-05,"Golden State Warriors",127,"Sacramento Kings",123,17583,0,-4,4,"2018-19",58.5365853658537
"3205",2019-01-06,"Brooklyn Nets",117,"Chicago Bulls",100,19265,0,-17,17,"2018-19",21.9512195121951
"3206",2019-01-06,"Orlando Magic",96,"Los Angeles Clippers",106,16616,1,10,10,"2018-19",59.0909090909091
"3207",2019-01-06,"Los Angeles Lakers",86,"Minnesota Timberwolves",108,18978,1,22,22,"2018-19",60.9756097560976
"3208",2019-01-06,"Miami Heat",82,"Atlanta Hawks",106,16630,1,24,24,"2018-19",41.4634146341463
"3209",2019-01-06,"Washington Wizards",116,"Oklahoma City Thunder",98,18203,0,-18,18,"2018-19",65.1162790697674
"3210",2019-01-06,"Indiana Pacers",105,"Toronto Raptors",121,19800,1,16,16,"2018-19",75.9259259259259
"3211",2019-01-06,"Charlotte Hornets",119,"Phoenix Suns",113,13110,0,-6,6,"2018-19",29.2682926829268
"3212",2019-01-07,"San Antonio Spurs",119,"Detroit Pistons",107,13107,0,-12,12,"2018-19",60.4651162790698
"3213",2019-01-07,"Brooklyn Nets",95,"Boston Celtics",116,18624,1,21,21,"2018-19",66.6666666666667
"3214",2019-01-07,"Denver Nuggets",113,"Houston Rockets",125,18055,1,12,12,"2018-19",76.5957446808511
"3215",2019-01-07,"Utah Jazz",102,"Milwaukee Bucks",114,17341,1,12,12,"2018-19",79.5918367346939
"3216",2019-01-07,"Memphis Grizzlies",95,"New Orleans Pelicans",114,14624,1,19,19,"2018-19",46.3414634146341
"3217",2019-01-07,"Los Angeles Lakers",107,"Dallas Mavericks",97,20354,0,-10,10,"2018-19",58.5365853658537
"3218",2019-01-07,"New York Knicks",101,"Portland Trail Blazers",111,19026,1,10,10,"2018-19",75.5102040816327
"3219",2019-01-07,"Orlando Magic",95,"Sacramento Kings",111,15724,1,16,16,"2018-19",58.5365853658537
"3220",2019-01-08,"Indiana Pacers",123,"Cleveland Cavaliers",115,19432,0,-8,8,"2018-19",31.7073170731707
"3221",2019-01-08,"Washington Wizards",115,"Philadelphia 76ers",132,20446,1,17,17,"2018-19",74.468085106383
"3222",2019-01-08,"Denver Nuggets",103,"Miami Heat",99,19600,0,-4,4,"2018-19",46.3414634146341
"3223",2019-01-08,"Atlanta Hawks",101,"Toronto Raptors",104,19800,1,3,3,"2018-19",75.9259259259259
"3224",2019-01-08,"Minnesota Timberwolves",119,"Oklahoma City Thunder",117,18203,0,-2,2,"2018-19",65.1162790697674
"3225",2019-01-08,"Sacramento Kings",111,"Phoenix Suns",115,13977,1,4,4,"2018-19",29.2682926829268
"3226",2019-01-08,"New York Knicks",95,"Golden State Warriors",122,19596,1,27,27,"2018-19",69.2307692307692
"3227",2019-01-08,"Charlotte Hornets",109,"Los Angeles Clippers",128,15275,1,19,19,"2018-19",59.0909090909091
"3228",2019-01-09,"Indiana Pacers",108,"Boston Celtics",135,18624,1,27,27,"2018-19",66.6666666666667
"3229",2019-01-09,"Philadelphia 76ers",106,"Washington Wizards",123,18039,1,17,17,"2018-19",53.6585365853659
"3230",2019-01-09,"Atlanta Hawks",100,"Brooklyn Nets",116,14531,1,16,16,"2018-19",53.4883720930233
"3231",2019-01-09,"Milwaukee Bucks",116,"Houston Rockets",109,18055,0,-7,7,"2018-19",76.5957446808511
"3232",2019-01-09,"San Antonio Spurs",86,"Memphis Grizzlies",96,13944,1,10,10,"2018-19",51.219512195122
"3233",2019-01-09,"Cleveland Cavaliers",124,"New Orleans Pelicans",140,15058,1,16,16,"2018-19",46.3414634146341
"3234",2019-01-09,"Phoenix Suns",94,"Dallas Mavericks",104,19596,1,10,10,"2018-19",58.5365853658537
"3235",2019-01-09,"Orlando Magic",93,"Utah Jazz",106,18306,1,13,13,"2018-19",69.7674418604651
"3236",2019-01-09,"Chicago Bulls",112,"Portland Trail Blazers",124,19393,1,12,12,"2018-19",75.5102040816327
"3237",2019-01-09,"Detroit Pistons",100,"Los Angeles Lakers",113,18997,1,13,13,"2018-19",53.6585365853659
"3238",2019-01-10,"Boston Celtics",99,"Miami Heat",115,19600,1,16,16,"2018-19",46.3414634146341
"3239",2019-01-10,"Los Angeles Clippers",100,"Denver Nuggets",121,15742,1,21,21,"2018-19",79.5918367346939
"3240",2019-01-10,"Oklahoma City Thunder",147,"San Antonio Spurs",154,18354,1,7,7,"2018-19",77.2727272727273
"3241",2019-01-10,"Detroit Pistons",102,"Sacramento Kings",112,16916,1,10,10,"2018-19",58.5365853658537
"3242",2019-01-11,"Atlanta Hawks",123,"Philadelphia 76ers",121,20487,0,-2,2,"2018-19",74.468085106383
"3243",2019-01-11,"Milwaukee Bucks",106,"Washington Wizards",113,17996,1,7,7,"2018-19",53.6585365853659
"3244",2019-01-11,"Indiana Pacers",121,"New York Knicks",106,19812,0,-15,15,"2018-19",21.9512195121951
"3245",2019-01-11,"Brooklyn Nets",105,"Toronto Raptors",122,19800,1,17,17,"2018-19",75.9259259259259
"3246",2019-01-11,"Cleveland Cavaliers",113,"Houston Rockets",141,18055,1,28,28,"2018-19",76.5957446808511
"3247",2019-01-11,"Dallas Mavericks",119,"Minnesota Timberwolves",115,18978,0,-4,4,"2018-19",60.9756097560976
"3248",2019-01-11,"Charlotte Hornets",96,"Portland Trail Blazers",127,19393,1,31,31,"2018-19",75.5102040816327
"3249",2019-01-11,"Los Angeles Lakers",95,"Utah Jazz",113,18306,1,18,18,"2018-19",69.7674418604651
"3250",2019-01-11,"Chicago Bulls",109,"Golden State Warriors",146,19596,1,37,37,"2018-19",69.2307692307692
"3251",2019-01-12,"Detroit Pistons",109,"Los Angeles Clippers",104,16540,0,-5,5,"2018-19",59.0909090909091
"3252",2019-01-12,"Memphis Grizzlies",108,"Miami Heat",112,19600,1,4,4,"2018-19",46.3414634146341
"3253",2019-01-12,"Boston Celtics",103,"Orlando Magic",105,18846,1,2,2,"2018-19",58.1395348837209
"3254",2019-01-12,"New Orleans Pelicans",106,"Minnesota Timberwolves",110,16384,1,4,4,"2018-19",60.9756097560976
"3255",2019-01-12,"San Antonio Spurs",112,"Oklahoma City Thunder",122,18203,1,10,10,"2018-19",65.1162790697674
"3256",2019-01-12,"Denver Nuggets",93,"Phoenix Suns",102,15246,1,9,9,"2018-19",29.2682926829268
"3257",2019-01-12,"Charlotte Hornets",97,"Sacramento Kings",104,17853,1,7,7,"2018-19",58.5365853658537
"3258",2019-01-12,"Chicago Bulls",102,"Utah Jazz",110,18306,1,8,8,"2018-19",69.7674418604651
"3259",2019-01-13,"Philadelphia 76ers",108,"New York Knicks",105,18596,0,-3,3,"2018-19",21.9512195121951
"3260",2019-01-13,"Toronto Raptors",140,"Washington Wizards",138,16919,0,-2,2,"2018-19",53.6585365853659
"3261",2019-01-13,"Milwaukee Bucks",133,"Atlanta Hawks",114,16292,0,-19,19,"2018-19",41.4634146341463
"3262",2019-01-13,"Houston Rockets",109,"Orlando Magic",116,16982,1,7,7,"2018-19",58.1395348837209
"3263",2019-01-13,"Golden State Warriors",119,"Dallas Mavericks",114,20340,0,-5,5,"2018-19",58.5365853658537
"3264",2019-01-13,"Portland Trail Blazers",113,"Denver Nuggets",116,19520,1,3,3,"2018-19",79.5918367346939
"3265",2019-01-13,"Cleveland Cavaliers",101,"Los Angeles Lakers",95,18997,0,-6,6,"2018-19",53.6585365853659
"3266",2019-01-14,"Boston Celtics",102,"Brooklyn Nets",109,16247,1,7,7,"2018-19",53.4883720930233
"3267",2019-01-14,"Memphis Grizzlies",94,"Houston Rockets",112,18055,1,18,18,"2018-19",76.5957446808511
"3268",2019-01-14,"Charlotte Hornets",108,"San Antonio Spurs",93,18354,0,-15,15,"2018-19",77.2727272727273
"3269",2019-01-14,"Detroit Pistons",94,"Utah Jazz",100,18306,1,6,6,"2018-19",69.7674418604651
"3270",2019-01-14,"Portland Trail Blazers",107,"Sacramento Kings",115,17583,1,8,8,"2018-19",58.5365853658537
"3271",2019-01-14,"New Orleans Pelicans",121,"Los Angeles Clippers",117,15283,0,-4,4,"2018-19",59.0909090909091
"3272",2019-01-15,"Phoenix Suns",97,"Indiana Pacers",131,15698,1,34,34,"2018-19",67.4418604651163
"3273",2019-01-15,"Minnesota Timberwolves",107,"Philadelphia 76ers",149,20265,1,42,42,"2018-19",74.468085106383
"3274",2019-01-15,"Oklahoma City Thunder",126,"Atlanta Hawks",142,15045,1,16,16,"2018-19",41.4634146341463
"3275",2019-01-15,"Miami Heat",86,"Milwaukee Bucks",124,17626,1,38,38,"2018-19",79.5918367346939
"3276",2019-01-15,"Golden State Warriors",142,"Denver Nuggets",111,19896,0,-31,31,"2018-19",79.5918367346939
"3277",2019-01-15,"Chicago Bulls",100,"Los Angeles Lakers",107,18997,1,7,7,"2018-19",53.6585365853659
"3278",2019-01-16,"Orlando Magic",115,"Detroit Pistons",120,14019,1,5,5,"2018-19",60.4651162790698
"3279",2019-01-16,"Toronto Raptors",108,"Boston Celtics",117,18624,1,9,9,"2018-19",66.6666666666667
"3280",2019-01-16,"Brooklyn Nets",145,"Houston Rockets",142,18055,0,-3,3,"2018-19",76.5957446808511
"3281",2019-01-16,"Milwaukee Bucks",111,"Memphis Grizzlies",101,14921,0,-10,10,"2018-19",51.219512195122
"3282",2019-01-16,"San Antonio Spurs",105,"Dallas Mavericks",101,20214,0,-4,4,"2018-19",58.5365853658537
"3283",2019-01-16,"Cleveland Cavaliers",112,"Portland Trail Blazers",129,19089,1,17,17,"2018-19",75.5102040816327
"3284",2019-01-16,"New Orleans Pelicans",140,"Golden State Warriors",147,19596,1,7,7,"2018-19",69.2307692307692
"3285",2019-01-16,"Utah Jazz",129,"Los Angeles Clippers",109,15535,0,-20,20,"2018-19",59.0909090909091
"3286",2019-01-17,"New York Knicks",100,"Washington Wizards",101,19078,1,1,1,"2018-19",53.6585365853659
"3287",2019-01-17,"Sacramento Kings",95,"Charlotte Hornets",114,15431,1,19,19,"2018-19",60.9756097560976
"3288",2019-01-17,"Philadelphia 76ers",120,"Indiana Pacers",96,16007,0,-24,24,"2018-19",67.4418604651163
"3289",2019-01-17,"Phoenix Suns",109,"Toronto Raptors",111,19800,1,2,2,"2018-19",75.9259259259259
"3290",2019-01-17,"Chicago Bulls",105,"Denver Nuggets",135,17289,1,30,30,"2018-19",79.5918367346939
"3291",2019-01-17,"Los Angeles Lakers",138,"Oklahoma City Thunder",128,18203,0,-10,10,"2018-19",65.1162790697674
"3292",2019-01-18,"Memphis Grizzlies",116,"Boston Celtics",122,18624,1,6,6,"2018-19",66.6666666666667
"3293",2019-01-18,"Miami Heat",93,"Detroit Pistons",98,17228,1,5,5,"2018-19",60.4651162790698
"3294",2019-01-18,"Brooklyn Nets",117,"Orlando Magic",115,17840,0,-2,2,"2018-19",58.1395348837209
"3295",2019-01-18,"San Antonio Spurs",116,"Minnesota Timberwolves",113,17222,0,-3,3,"2018-19",60.9756097560976
"3296",2019-01-18,"Cleveland Cavaliers",99,"Utah Jazz",115,18306,1,16,16,"2018-19",69.7674418604651
"3297",2019-01-18,"Golden State Warriors",112,"Los Angeles Clippers",94,19068,0,-18,18,"2018-19",59.0909090909091
"3298",2019-01-18,"New Orleans Pelicans",112,"Portland Trail Blazers",128,19598,1,16,16,"2018-19",75.5102040816327
"3299",2019-01-19,"Oklahoma City Thunder",117,"Philadelphia 76ers",115,20646,0,-2,2,"2018-19",74.468085106383
"3300",2019-01-19,"Phoenix Suns",115,"Charlotte Hornets",135,19278,1,20,20,"2018-19",60.9756097560976
"3301",2019-01-19,"Sacramento Kings",103,"Detroit Pistons",101,15377,0,-2,2,"2018-19",60.4651162790698
"3302",2019-01-19,"Dallas Mavericks",99,"Indiana Pacers",111,17508,1,12,12,"2018-19",67.4418604651163
"3303",2019-01-19,"Milwaukee Bucks",118,"Orlando Magic",108,18846,0,-10,10,"2018-19",58.1395348837209
"3304",2019-01-19,"Boston Celtics",113,"Atlanta Hawks",105,16626,0,-8,8,"2018-19",41.4634146341463
"3305",2019-01-19,"Memphis Grizzlies",90,"Toronto Raptors",119,19800,1,29,29,"2018-19",75.9259259259259
"3306",2019-01-19,"Miami Heat",117,"Chicago Bulls",103,20926,0,-14,14,"2018-19",21.9512195121951
"3307",2019-01-19,"Los Angeles Lakers",134,"Houston Rockets",138,18055,1,4,4,"2018-19",76.5957446808511
"3308",2019-01-19,"Cleveland Cavaliers",102,"Denver Nuggets",124,19520,1,22,22,"2018-19",79.5918367346939
"3309",2019-01-20,"Charlotte Hornets",95,"Indiana Pacers",120,15015,1,25,25,"2018-19",67.4418604651163
"3310",2019-01-20,"Phoenix Suns",114,"Minnesota Timberwolves",116,14607,1,2,2,"2018-19",60.9756097560976
"3311",2019-01-20,"Los Angeles Clippers",103,"San Antonio Spurs",95,18354,0,-8,8,"2018-19",77.2727272727273
"3312",2019-01-21,"Oklahoma City Thunder",127,"New York Knicks",109,19493,0,-18,18,"2018-19",21.9512195121951
"3313",2019-01-21,"Chicago Bulls",104,"Cleveland Cavaliers",88,19432,0,-16,16,"2018-19",31.7073170731707
"3314",2019-01-21,"Dallas Mavericks",106,"Milwaukee Bucks",116,17963,1,10,10,"2018-19",79.5918367346939
"3315",2019-01-21,"Detroit Pistons",87,"Washington Wizards",101,16229,1,14,14,"2018-19",53.6585365853659
"3316",2019-01-21,"Orlando Magic",122,"Atlanta Hawks",103,16611,0,-19,19,"2018-19",41.4634146341463
"3317",2019-01-21,"Sacramento Kings",94,"Brooklyn Nets",123,14233,1,29,29,"2018-19",53.4883720930233
"3318",2019-01-21,"New Orleans Pelicans",105,"Memphis Grizzlies",85,17794,0,-20,20,"2018-19",51.219512195122
"3319",2019-01-21,"Miami Heat",99,"Boston Celtics",107,18624,1,8,8,"2018-19",66.6666666666667
"3320",2019-01-21,"Houston Rockets",93,"Philadelphia 76ers",121,20313,1,28,28,"2018-19",74.468085106383
"3321",2019-01-21,"Portland Trail Blazers",109,"Utah Jazz",104,18306,0,-5,5,"2018-19",69.7674418604651
"3322",2019-01-21,"Golden State Warriors",130,"Los Angeles Lakers",111,18997,0,-19,19,"2018-19",53.6585365853659
"3323",2019-01-22,"Sacramento Kings",105,"Toronto Raptors",120,19800,1,15,15,"2018-19",75.9259259259259
"3324",2019-01-22,"Portland Trail Blazers",114,"Oklahoma City Thunder",123,18203,1,9,9,"2018-19",65.1162790697674
"3325",2019-01-22,"Los Angeles Clippers",98,"Dallas Mavericks",106,19466,1,8,8,"2018-19",58.5365853658537
"3326",2019-01-22,"Minnesota Timberwolves",118,"Phoenix Suns",91,14460,0,-27,27,"2018-19",29.2682926829268
"3327",2019-01-23,"Toronto Raptors",106,"Indiana Pacers",110,16879,1,4,4,"2018-19",67.4418604651163
"3328",2019-01-23,"Cleveland Cavaliers",103,"Boston Celtics",123,18624,1,20,20,"2018-19",66.6666666666667
"3329",2019-01-23,"Orlando Magic",110,"Brooklyn Nets",114,13185,1,4,4,"2018-19",53.4883720930233
"3330",2019-01-23,"Los Angeles Clippers",111,"Miami Heat",99,19600,0,-12,12,"2018-19",46.3414634146341
"3331",2019-01-23,"Houston Rockets",114,"New York Knicks",110,18819,0,-4,4,"2018-19",21.9512195121951
"3332",2019-01-23,"Atlanta Hawks",121,"Chicago Bulls",101,18223,0,-20,20,"2018-19",21.9512195121951
"3333",2019-01-23,"Charlotte Hornets",118,"Memphis Grizzlies",107,12863,0,-11,11,"2018-19",51.219512195122
"3334",2019-01-23,"Detroit Pistons",98,"New Orleans Pelicans",94,18181,0,-4,4,"2018-19",46.3414634146341
"3335",2019-01-23,"San Antonio Spurs",120,"Philadelphia 76ers",122,20339,1,2,2,"2018-19",74.468085106383
"3336",2019-01-23,"Denver Nuggets",108,"Utah Jazz",114,18306,1,6,6,"2018-19",69.7674418604651
"3337",2019-01-24,"New Orleans Pelicans",116,"Oklahoma City Thunder",122,18203,1,6,6,"2018-19",65.1162790697674
"3338",2019-01-24,"Golden State Warriors",126,"Washington Wizards",118,20409,0,-8,8,"2018-19",53.6585365853659
"3339",2019-01-24,"Portland Trail Blazers",120,"Phoenix Suns",106,15441,0,-14,14,"2018-19",29.2682926829268
"3340",2019-01-24,"Minnesota Timberwolves",120,"Los Angeles Lakers",105,18997,0,-15,15,"2018-19",53.6585365853659
"3341",2019-01-25,"Washington Wizards",95,"Orlando Magic",91,17216,0,-4,4,"2018-19",58.1395348837209
"3342",2019-01-25,"New York Knicks",99,"Brooklyn Nets",109,17033,1,10,10,"2018-19",53.4883720930233
"3343",2019-01-25,"Miami Heat",100,"Cleveland Cavaliers",94,19432,0,-6,6,"2018-19",31.7073170731707
"3344",2019-01-25,"Los Angeles Clippers",106,"Chicago Bulls",101,19354,0,-5,5,"2018-19",21.9512195121951
"3345",2019-01-25,"Toronto Raptors",119,"Houston Rockets",121,18055,1,2,2,"2018-19",76.5957446808511
"3346",2019-01-25,"Sacramento Kings",99,"Memphis Grizzlies",96,14486,0,-3,3,"2018-19",51.219512195122
"3347",2019-01-25,"Detroit Pistons",101,"Dallas Mavericks",106,20327,1,5,5,"2018-19",58.5365853658537
"3348",2019-01-25,"Charlotte Hornets",99,"Milwaukee Bucks",108,17803,1,9,9,"2018-19",79.5918367346939
"3349",2019-01-25,"Phoenix Suns",95,"Denver Nuggets",132,17425,1,37,37,"2018-19",79.5918367346939
"3350",2019-01-25,"Minnesota Timberwolves",102,"Utah Jazz",106,18306,1,4,4,"2018-19",69.7674418604651
"3351",2019-01-26,"San Antonio Spurs",126,"New Orleans Pelicans",114,17724,0,-12,12,"2018-19",46.3414634146341
"3352",2019-01-26,"Indiana Pacers",103,"Memphis Grizzlies",106,14486,1,3,3,"2018-19",51.219512195122
"3353",2019-01-26,"Golden State Warriors",115,"Boston Celtics",111,18624,0,-4,4,"2018-19",66.6666666666667
"3354",2019-01-26,"Philadelphia 76ers",110,"Denver Nuggets",126,19673,1,16,16,"2018-19",79.5918367346939
"3355",2019-01-26,"Atlanta Hawks",111,"Portland Trail Blazers",120,19629,1,9,9,"2018-19",75.5102040816327
"3356",2019-01-27,"Cleveland Cavaliers",104,"Chicago Bulls",101,19675,0,-3,3,"2018-19",21.9512195121951
"3357",2019-01-27,"Sacramento Kings",108,"Los Angeles Clippers",122,19068,1,14,14,"2018-19",59.0909090909091
"3358",2019-01-27,"Milwaukee Bucks",112,"Oklahoma City Thunder",118,18203,1,6,6,"2018-19",65.1162790697674
"3359",2019-01-27,"Toronto Raptors",123,"Dallas Mavericks",120,20308,0,-3,3,"2018-19",58.5365853658537
"3360",2019-01-27,"Orlando Magic",98,"Houston Rockets",103,18055,1,5,5,"2018-19",76.5957446808511
"3361",2019-01-27,"Utah Jazz",125,"Minnesota Timberwolves",111,14542,0,-14,14,"2018-19",60.9756097560976
"3362",2019-01-27,"Washington Wizards",119,"San Antonio Spurs",132,18354,1,13,13,"2018-19",77.2727272727273
"3363",2019-01-27,"Miami Heat",106,"New York Knicks",97,18852,0,-9,9,"2018-19",21.9512195121951
"3364",2019-01-27,"Phoenix Suns",102,"Los Angeles Lakers",116,18997,1,14,14,"2018-19",53.6585365853659
"3365",2019-01-28,"New York Knicks",92,"Charlotte Hornets",101,13963,1,9,9,"2018-19",60.9756097560976
"3366",2019-01-28,"Golden State Warriors",132,"Indiana Pacers",100,17923,0,-32,32,"2018-19",67.4418604651163
"3367",2019-01-28,"Brooklyn Nets",104,"Boston Celtics",112,18624,1,8,8,"2018-19",66.6666666666667
"3368",2019-01-28,"Denver Nuggets",95,"Memphis Grizzlies",92,12917,0,-3,3,"2018-19",51.219512195122
"3369",2019-01-28,"Atlanta Hawks",123,"Los Angeles Clippers",118,17382,0,-5,5,"2018-19",59.0909090909091
"3370",2019-01-29,"Washington Wizards",113,"Cleveland Cavaliers",116,19432,1,3,3,"2018-19",31.7073170731707
"3371",2019-01-29,"Milwaukee Bucks",115,"Detroit Pistons",105,14187,0,-10,10,"2018-19",60.4651162790698
"3372",2019-01-29,"Oklahoma City Thunder",126,"Orlando Magic",117,16341,0,-9,9,"2018-19",58.1395348837209
"3373",2019-01-29,"Chicago Bulls",117,"Brooklyn Nets",122,12726,1,5,5,"2018-19",53.4883720930233
"3374",2019-01-29,"New Orleans Pelicans",121,"Houston Rockets",116,18055,0,-5,5,"2018-19",76.5957446808511
"3375",2019-01-29,"Phoenix Suns",124,"San Antonio Spurs",126,18121,1,2,2,"2018-19",77.2727272727273
"3376",2019-01-29,"Philadelphia 76ers",121,"Los Angeles Lakers",105,18997,0,-16,16,"2018-19",53.6585365853659
"3377",2019-01-30,"Charlotte Hornets",94,"Boston Celtics",126,18624,1,32,32,"2018-19",66.6666666666667
"3378",2019-01-30,"Chicago Bulls",105,"Miami Heat",89,19600,0,-16,16,"2018-19",46.3414634146341
"3379",2019-01-30,"Dallas Mavericks",114,"New York Knicks",90,18842,0,-24,24,"2018-19",21.9512195121951
"3380",2019-01-30,"Memphis Grizzlies",97,"Minnesota Timberwolves",99,13615,1,2,2,"2018-19",60.9756097560976
"3381",2019-01-30,"Denver Nuggets",105,"New Orleans Pelicans",99,14211,0,-6,6,"2018-19",46.3414634146341
"3382",2019-01-30,"Indiana Pacers",89,"Washington Wizards",107,15354,1,18,18,"2018-19",53.6585365853659
"3383",2019-01-30,"Atlanta Hawks",113,"Sacramento Kings",135,17583,1,22,22,"2018-19",58.5365853658537
"3384",2019-01-30,"Utah Jazz",105,"Portland Trail Blazers",132,19393,1,27,27,"2018-19",75.5102040816327
"3385",2019-01-31,"Dallas Mavericks",89,"Detroit Pistons",93,14075,1,4,4,"2018-19",60.4651162790698
"3386",2019-01-31,"Indiana Pacers",100,"Orlando Magic",107,16625,1,7,7,"2018-19",58.1395348837209
"3387",2019-01-31,"Milwaukee Bucks",105,"Toronto Raptors",92,19800,0,-13,13,"2018-19",75.9259259259259
"3388",2019-01-31,"Brooklyn Nets",114,"San Antonio Spurs",117,18057,1,3,3,"2018-19",77.2727272727273
"3389",2019-01-31,"Philadelphia 76ers",113,"Golden State Warriors",104,19596,0,-9,9,"2018-19",69.2307692307692
"3390",2019-01-31,"Los Angeles Lakers",123,"Los Angeles Clippers",120,19068,0,-3,3,"2018-19",59.0909090909091
"3391",2019-02-01,"Memphis Grizzlies",92,"Charlotte Hornets",100,15387,1,8,8,"2018-19",60.9756097560976
"3392",2019-02-01,"Boston Celtics",113,"New York Knicks",99,18343,0,-14,14,"2018-19",21.9512195121951
"3393",2019-02-01,"Oklahoma City Thunder",118,"Miami Heat",102,19600,0,-16,16,"2018-19",46.3414634146341
"3394",2019-02-01,"Atlanta Hawks",112,"Utah Jazz",128,18306,1,16,16,"2018-19",69.7674418604651
"3395",2019-02-01,"Houston Rockets",122,"Denver Nuggets",136,20106,1,14,14,"2018-19",79.5918367346939
"3396",2019-02-02,"Los Angeles Clippers",111,"Detroit Pistons",101,17862,0,-10,10,"2018-19",60.4651162790698
"3397",2019-02-02,"Chicago Bulls",118,"Charlotte Hornets",125,19114,1,7,7,"2018-19",60.9756097560976
"3398",2019-02-02,"Brooklyn Nets",89,"Orlando Magic",102,17385,1,13,13,"2018-19",58.1395348837209
"3399",2019-02-02,"Milwaukee Bucks",131,"Washington Wizards",115,20409,0,-16,16,"2018-19",53.6585365853659
"3400",2019-02-02,"Dallas Mavericks",111,"Cleveland Cavaliers",98,19432,0,-13,13,"2018-19",31.7073170731707
"3401",2019-02-02,"Indiana Pacers",95,"Miami Heat",88,19600,0,-7,7,"2018-19",46.3414634146341
"3402",2019-02-02,"Los Angeles Lakers",101,"Golden State Warriors",115,19596,1,14,14,"2018-19",69.2307692307692
"3403",2019-02-02,"New Orleans Pelicans",108,"San Antonio Spurs",113,18354,1,5,5,"2018-19",77.2727272727273
"3404",2019-02-02,"Denver Nuggets",107,"Minnesota Timberwolves",106,17208,0,-1,1,"2018-19",60.9756097560976
"3405",2019-02-02,"Atlanta Hawks",118,"Phoenix Suns",112,15534,0,-6,6,"2018-19",29.2682926829268
"3406",2019-02-02,"Houston Rockets",125,"Utah Jazz",98,18306,0,-27,27,"2018-19",69.7674418604651
"3407",2019-02-02,"Philadelphia 76ers",108,"Sacramento Kings",115,17583,1,7,7,"2018-19",58.5365853658537
"3408",2019-02-03,"Memphis Grizzlies",96,"New York Knicks",84,17025,0,-12,12,"2018-19",21.9512195121951
"3409",2019-02-03,"Oklahoma City Thunder",129,"Boston Celtics",134,18624,1,5,5,"2018-19",66.6666666666667
"3410",2019-02-03,"Los Angeles Clippers",103,"Toronto Raptors",121,19800,1,18,18,"2018-19",75.9259259259259
"3411",2019-02-04,"Denver Nuggets",103,"Detroit Pistons",129,12589,1,26,26,"2018-19",60.4651162790698
"3412",2019-02-04,"Atlanta Hawks",137,"Washington Wizards",129,15025,0,-8,8,"2018-19",53.6585365853659
"3413",2019-02-04,"Milwaukee Bucks",113,"Brooklyn Nets",94,16209,0,-19,19,"2018-19",53.4883720930233
"3414",2019-02-04,"Indiana Pacers",109,"New Orleans Pelicans",107,15780,0,-2,2,"2018-19",46.3414634146341
"3415",2019-02-04,"Houston Rockets",118,"Phoenix Suns",110,15740,0,-8,8,"2018-19",29.2682926829268
"3416",2019-02-04,"San Antonio Spurs",112,"Sacramento Kings",127,16245,1,15,15,"2018-19",58.5365853658537
"3417",2019-02-05,"Los Angeles Clippers",117,"Charlotte Hornets",115,14300,0,-2,2,"2018-19",60.9756097560976
"3418",2019-02-05,"Boston Celtics",103,"Cleveland Cavaliers",96,19432,0,-7,7,"2018-19",31.7073170731707
"3419",2019-02-05,"Los Angeles Lakers",94,"Indiana Pacers",136,17265,1,42,42,"2018-19",67.4418604651163
"3420",2019-02-05,"Detroit Pistons",105,"New York Knicks",92,17853,0,-13,13,"2018-19",21.9512195121951
"3421",2019-02-05,"Minnesota Timberwolves",106,"Memphis Grizzlies",108,13454,1,2,2,"2018-19",51.219512195122
"3422",2019-02-05,"Orlando Magic",122,"Oklahoma City Thunder",132,18203,1,10,10,"2018-19",65.1162790697674
"3423",2019-02-05,"Toronto Raptors",119,"Philadelphia 76ers",107,20472,0,-12,12,"2018-19",74.468085106383
"3424",2019-02-05,"Miami Heat",118,"Portland Trail Blazers",108,19468,0,-10,10,"2018-19",75.5102040816327
"3425",2019-02-06,"Denver Nuggets",130,"Brooklyn Nets",135,14516,1,5,5,"2018-19",53.4883720930233
"3426",2019-02-06,"New Orleans Pelicans",125,"Chicago Bulls",120,18116,0,-5,5,"2018-19",21.9512195121951
"3427",2019-02-06,"Washington Wizards",129,"Milwaukee Bucks",148,17360,1,19,19,"2018-19",79.5918367346939
"3428",2019-02-06,"Charlotte Hornets",93,"Dallas Mavericks",99,19606,1,6,6,"2018-19",58.5365853658537
"3429",2019-02-06,"Phoenix Suns",88,"Utah Jazz",116,18306,1,28,28,"2018-19",69.7674418604651
"3430",2019-02-06,"Houston Rockets",127,"Sacramento Kings",101,17583,0,-26,26,"2018-19",58.5365853658537
"3431",2019-02-06,"San Antonio Spurs",102,"Golden State Warriors",141,19596,1,39,39,"2018-19",69.2307692307692
"3432",2019-02-07,"Los Angeles Clippers",92,"Indiana Pacers",116,15756,1,24,24,"2018-19",67.4418604651163
"3433",2019-02-07,"Minnesota Timberwolves",112,"Orlando Magic",122,17184,1,10,10,"2018-19",58.1395348837209
"3434",2019-02-07,"Toronto Raptors",119,"Atlanta Hawks",101,16036,0,-18,18,"2018-19",41.4634146341463
"3435",2019-02-07,"Los Angeles Lakers",129,"Boston Celtics",128,18624,0,-1,1,"2018-19",66.6666666666667
"3436",2019-02-07,"Memphis Grizzlies",95,"Oklahoma City Thunder",117,18203,1,22,22,"2018-19",65.1162790697674
"3437",2019-02-07,"San Antonio Spurs",118,"Portland Trail Blazers",127,19393,1,9,9,"2018-19",75.5102040816327
"3438",2019-02-08,"New York Knicks",103,"Detroit Pistons",120,14430,1,17,17,"2018-19",60.4651162790698
"3439",2019-02-08,"Denver Nuggets",110,"Philadelphia 76ers",117,20627,1,7,7,"2018-19",74.468085106383
"3440",2019-02-08,"Cleveland Cavaliers",106,"Washington Wizards",119,16682,1,13,13,"2018-19",53.6585365853659
"3441",2019-02-08,"Chicago Bulls",125,"Brooklyn Nets",106,15267,0,-19,19,"2018-19",53.4883720930233
"3442",2019-02-08,"Milwaukee Bucks",122,"Dallas Mavericks",107,20420,0,-15,15,"2018-19",58.5365853658537
"3443",2019-02-08,"Golden State Warriors",117,"Phoenix Suns",107,17081,0,-10,10,"2018-19",29.2682926829268
"3444",2019-02-08,"Minnesota Timberwolves",117,"New Orleans Pelicans",122,16980,1,5,5,"2018-19",46.3414634146341
"3445",2019-02-08,"Miami Heat",96,"Sacramento Kings",102,17583,1,6,6,"2018-19",58.5365853658537
"3446",2019-02-09,"San Antonio Spurs",105,"Utah Jazz",125,18306,1,20,20,"2018-19",69.7674418604651
"3447",2019-02-09,"Cleveland Cavaliers",90,"Indiana Pacers",105,17923,1,15,15,"2018-19",67.4418604651163
"3448",2019-02-09,"Charlotte Hornets",129,"Atlanta Hawks",120,15048,0,-9,9,"2018-19",41.4634146341463
"3449",2019-02-09,"Toronto Raptors",104,"New York Knicks",99,18886,0,-5,5,"2018-19",21.9512195121951
"3450",2019-02-09,"Los Angeles Clippers",123,"Boston Celtics",112,18624,0,-11,11,"2018-19",66.6666666666667
"3451",2019-02-09,"Washington Wizards",134,"Chicago Bulls",125,19942,0,-9,9,"2018-19",21.9512195121951
"3452",2019-02-09,"New Orleans Pelicans",90,"Memphis Grizzlies",99,16841,1,9,9,"2018-19",51.219512195122
"3453",2019-02-09,"Oklahoma City Thunder",117,"Houston Rockets",112,18061,0,-5,5,"2018-19",76.5957446808511
"3454",2019-02-09,"Orlando Magic",103,"Milwaukee Bucks",83,17812,0,-20,20,"2018-19",79.5918367346939
"3455",2019-02-10,"Portland Trail Blazers",101,"Dallas Mavericks",102,20340,1,1,1,"2018-19",58.5365853658537
"3456",2019-02-10,"Los Angeles Lakers",120,"Philadelphia 76ers",143,20683,1,23,23,"2018-19",74.468085106383
"3457",2019-02-10,"Phoenix Suns",104,"Sacramento Kings",117,17583,1,13,13,"2018-19",58.5365853658537
"3458",2019-02-10,"Orlando Magic",124,"Atlanta Hawks",108,13370,0,-16,16,"2018-19",41.4634146341463
"3459",2019-02-10,"Miami Heat",118,"Golden State Warriors",120,19596,1,2,2,"2018-19",69.2307692307692
"3460",2019-02-11,"New York Knicks",104,"Cleveland Cavaliers",107,19432,1,3,3,"2018-19",31.7073170731707
"3461",2019-02-11,"Washington Wizards",112,"Detroit Pistons",121,15246,1,9,9,"2018-19",60.4651162790698
"3462",2019-02-11,"Charlotte Hornets",90,"Indiana Pacers",99,15734,1,9,9,"2018-19",67.4418604651163
"3463",2019-02-11,"Brooklyn Nets",125,"Toronto Raptors",127,19800,1,2,2,"2018-19",75.9259259259259
"3464",2019-02-11,"Milwaukee Bucks",112,"Chicago Bulls",99,18833,0,-13,13,"2018-19",21.9512195121951
"3465",2019-02-11,"Dallas Mavericks",104,"Houston Rockets",120,18055,1,16,16,"2018-19",76.5957446808511
"3466",2019-02-11,"Los Angeles Clippers",120,"Minnesota Timberwolves",130,13782,1,10,10,"2018-19",60.9756097560976
"3467",2019-02-11,"Portland Trail Blazers",111,"Oklahoma City Thunder",120,18203,1,9,9,"2018-19",65.1162790697674
"3468",2019-02-11,"Miami Heat",87,"Denver Nuggets",103,18378,1,16,16,"2018-19",79.5918367346939
"3469",2019-02-12,"Los Angeles Lakers",113,"Atlanta Hawks",117,16824,1,4,4,"2018-19",41.4634146341463
"3470",2019-02-12,"San Antonio Spurs",108,"Memphis Grizzlies",107,13788,0,-1,1,"2018-19",51.219512195122
"3471",2019-02-12,"Orlando Magic",118,"New Orleans Pelicans",88,15733,0,-30,30,"2018-19",46.3414634146341
"3472",2019-02-12,"Boston Celtics",112,"Philadelphia 76ers",109,20582,0,-3,3,"2018-19",74.468085106383
"3473",2019-02-12,"Utah Jazz",108,"Golden State Warriors",115,19596,1,7,7,"2018-19",69.2307692307692
"3474",2019-02-13,"Brooklyn Nets",148,"Cleveland Cavaliers",139,17434,0,-9,9,"2018-19",31.7073170731707
"3475",2019-02-13,"Milwaukee Bucks",106,"Indiana Pacers",97,17311,0,-9,9,"2018-19",67.4418604651163
"3476",2019-02-13,"Detroit Pistons",110,"Boston Celtics",118,18624,1,8,8,"2018-19",66.6666666666667
"3477",2019-02-13,"Philadelphia 76ers",126,"New York Knicks",111,18983,0,-15,15,"2018-19",21.9512195121951
"3478",2019-02-13,"Washington Wizards",120,"Toronto Raptors",129,19800,1,9,9,"2018-19",75.9259259259259
"3479",2019-02-13,"Memphis Grizzlies",110,"Chicago Bulls",122,19114,1,12,12,"2018-19",21.9512195121951
"3480",2019-02-13,"Houston Rockets",111,"Minnesota Timberwolves",121,15131,1,10,10,"2018-19",60.9756097560976
"3481",2019-02-13,"Miami Heat",112,"Dallas Mavericks",101,20364,0,-11,11,"2018-19",58.5365853658537
"3482",2019-02-13,"Sacramento Kings",118,"Denver Nuggets",120,17938,1,2,2,"2018-19",79.5918367346939
"3483",2019-02-13,"Phoenix Suns",107,"Los Angeles Clippers",134,17703,1,27,27,"2018-19",59.0909090909091
"3484",2019-02-13,"Golden State Warriors",107,"Portland Trail Blazers",129,19549,1,22,22,"2018-19",75.5102040816327
"3485",2019-02-14,"Charlotte Hornets",89,"Orlando Magic",127,18846,1,38,38,"2018-19",58.1395348837209
"3486",2019-02-14,"New York Knicks",106,"Atlanta Hawks",91,14179,0,-15,15,"2018-19",41.4634146341463
"3487",2019-02-14,"Oklahoma City Thunder",122,"New Orleans Pelicans",131,15686,1,9,9,"2018-19",46.3414634146341
"3488",2019-02-21,"Phoenix Suns",98,"Cleveland Cavaliers",111,19022,1,13,13,"2018-19",31.7073170731707
"3489",2019-02-21,"Miami Heat",102,"Philadelphia 76ers",106,20505,1,4,4,"2018-19",74.468085106383
"3490",2019-02-21,"Portland Trail Blazers",113,"Brooklyn Nets",99,17732,0,-14,14,"2018-19",53.4883720930233
"3491",2019-02-21,"Boston Celtics",97,"Milwaukee Bucks",98,17926,1,1,1,"2018-19",79.5918367346939
"3492",2019-02-21,"Sacramento Kings",123,"Golden State Warriors",125,19596,1,2,2,"2018-19",69.2307692307692
"3493",2019-02-21,"Houston Rockets",106,"Los Angeles Lakers",111,18997,1,5,5,"2018-19",53.6585365853659
"3494",2019-02-22,"Washington Wizards",110,"Charlotte Hornets",123,15572,1,13,13,"2018-19",60.9756097560976
"3495",2019-02-22,"New Orleans Pelicans",111,"Indiana Pacers",126,16962,1,15,15,"2018-19",67.4418604651163
"3496",2019-02-22,"Chicago Bulls",110,"Orlando Magic",109,18846,0,-1,1,"2018-19",58.1395348837209
"3497",2019-02-22,"San Antonio Spurs",117,"Toronto Raptors",120,20058,1,3,3,"2018-19",75.9259259259259
"3498",2019-02-22,"Detroit Pistons",125,"Atlanta Hawks",122,14067,0,-3,3,"2018-19",41.4634146341463
"3499",2019-02-22,"Minnesota Timberwolves",115,"New York Knicks",104,19096,0,-11,11,"2018-19",21.9512195121951
"3500",2019-02-22,"Los Angeles Clippers",112,"Memphis Grizzlies",106,16444,0,-6,6,"2018-19",51.219512195122
"3501",2019-02-22,"Denver Nuggets",114,"Dallas Mavericks",104,20382,0,-10,10,"2018-19",58.5365853658537
"3502",2019-02-22,"Utah Jazz",147,"Oklahoma City Thunder",148,18203,1,1,1,"2018-19",65.1162790697674
"3503",2019-02-23,"Portland Trail Blazers",130,"Philadelphia 76ers",115,20619,0,-15,15,"2018-19",74.468085106383
"3504",2019-02-23,"Phoenix Suns",112,"Atlanta Hawks",120,15214,1,8,8,"2018-19",41.4634146341463
"3505",2019-02-23,"Brooklyn Nets",117,"Charlotte Hornets",115,19158,0,-2,2,"2018-19",60.9756097560976
"3506",2019-02-23,"Memphis Grizzlies",107,"Cleveland Cavaliers",112,19432,1,5,5,"2018-19",31.7073170731707
"3507",2019-02-23,"Los Angeles Lakers",115,"New Orleans Pelicans",128,18626,1,13,13,"2018-19",46.3414634146341
"3508",2019-02-23,"Indiana Pacers",119,"Washington Wizards",112,19648,0,-7,7,"2018-19",53.6585365853659
"3509",2019-02-23,"Detroit Pistons",119,"Miami Heat",96,19600,0,-23,23,"2018-19",46.3414634146341
"3510",2019-02-23,"Boston Celtics",116,"Chicago Bulls",126,21295,1,10,10,"2018-19",21.9512195121951
"3511",2019-02-23,"Sacramento Kings",119,"Oklahoma City Thunder",116,18203,0,-3,3,"2018-19",65.1162790697674
"3512",2019-02-23,"Houston Rockets",118,"Golden State Warriors",112,19596,0,-6,6,"2018-19",69.2307692307692
"3513",2019-02-23,"Minnesota Timberwolves",128,"Milwaukee Bucks",140,17972,1,12,12,"2018-19",79.5918367346939
"3514",2019-02-23,"Dallas Mavericks",109,"Utah Jazz",125,18306,1,16,16,"2018-19",69.7674418604651
"3515",2019-02-24,"Orlando Magic",113,"Toronto Raptors",98,19800,0,-15,15,"2018-19",75.9259259259259
"3516",2019-02-24,"Los Angeles Clippers",96,"Denver Nuggets",123,19956,1,27,27,"2018-19",79.5918367346939
"3517",2019-02-24,"San Antonio Spurs",118,"New York Knicks",130,18019,1,12,12,"2018-19",21.9512195121951
"3518",2019-02-25,"Golden State Warriors",121,"Charlotte Hornets",110,19419,0,-11,11,"2018-19",60.9756097560976
"3519",2019-02-25,"Portland Trail Blazers",123,"Cleveland Cavaliers",110,19432,0,-13,13,"2018-19",31.7073170731707
"3520",2019-02-25,"Indiana Pacers",109,"Detroit Pistons",113,15321,1,4,4,"2018-19",60.4651162790698
"3521",2019-02-25,"San Antonio Spurs",85,"Brooklyn Nets",101,13479,1,16,16,"2018-19",53.4883720930233
"3522",2019-02-25,"Phoenix Suns",124,"Miami Heat",121,19600,0,-3,3,"2018-19",46.3414634146341
"3523",2019-02-25,"Milwaukee Bucks",117,"Chicago Bulls",106,20936,0,-11,11,"2018-19",21.9512195121951
"3524",2019-02-25,"Atlanta Hawks",111,"Houston Rockets",119,18055,1,8,8,"2018-19",76.5957446808511
"3525",2019-02-25,"Los Angeles Lakers",105,"Memphis Grizzlies",110,17794,1,5,5,"2018-19",51.219512195122
"3526",2019-02-25,"Sacramento Kings",105,"Minnesota Timberwolves",112,13691,1,7,7,"2018-19",60.9756097560976
"3527",2019-02-25,"Philadelphia 76ers",111,"New Orleans Pelicans",110,17194,0,-1,1,"2018-19",46.3414634146341
"3528",2019-02-25,"Dallas Mavericks",112,"Los Angeles Clippers",121,19068,1,9,9,"2018-19",59.0909090909091
"3529",2019-02-26,"Orlando Magic",103,"New York Knicks",108,17833,1,5,5,"2018-19",21.9512195121951
"3530",2019-02-26,"Boston Celtics",95,"Toronto Raptors",118,19800,1,23,23,"2018-19",75.9259259259259
"3531",2019-02-26,"Oklahoma City Thunder",112,"Denver Nuggets",121,18378,1,9,9,"2018-19",79.5918367346939
"3532",2019-02-27,"Houston Rockets",118,"Charlotte Hornets",113,17903,0,-5,5,"2018-19",60.9756097560976
"3533",2019-02-27,"Minnesota Timberwolves",123,"Atlanta Hawks",131,14101,1,8,8,"2018-19",41.4634146341463
"3534",2019-02-27,"Washington Wizards",125,"Brooklyn Nets",116,13683,0,-9,9,"2018-19",53.4883720930233
"3535",2019-02-27,"Golden State Warriors",125,"Miami Heat",126,19647,1,1,1,"2018-19",46.3414634146341
"3536",2019-02-27,"Portland Trail Blazers",97,"Boston Celtics",92,18624,0,-5,5,"2018-19",66.6666666666667
"3537",2019-02-27,"Chicago Bulls",109,"Memphis Grizzlies",107,13711,0,-2,2,"2018-19",51.219512195122
"3538",2019-02-27,"Indiana Pacers",101,"Dallas Mavericks",110,19978,1,9,9,"2018-19",58.5365853658537
"3539",2019-02-27,"Detroit Pistons",93,"San Antonio Spurs",105,18354,1,12,12,"2018-19",77.2727272727273
"3540",2019-02-27,"Los Angeles Clippers",105,"Utah Jazz",111,18306,1,6,6,"2018-19",69.7674418604651
"3541",2019-02-27,"Milwaukee Bucks",141,"Sacramento Kings",140,17583,0,-1,1,"2018-19",58.5365853658537
"3542",2019-02-27,"New Orleans Pelicans",119,"Los Angeles Lakers",125,18997,1,6,6,"2018-19",53.6585365853659
"3543",2019-02-28,"Minnesota Timberwolves",115,"Indiana Pacers",122,17003,1,7,7,"2018-19",67.4418604651163
"3544",2019-02-28,"Golden State Warriors",96,"Orlando Magic",103,18846,1,7,7,"2018-19",58.1395348837209
"3545",2019-02-28,"Cleveland Cavaliers",125,"New York Knicks",118,17573,0,-7,7,"2018-19",21.9512195121951
"3546",2019-02-28,"Miami Heat",118,"Houston Rockets",121,18119,1,3,3,"2018-19",76.5957446808511
"3547",2019-02-28,"Philadelphia 76ers",108,"Oklahoma City Thunder",104,18203,0,-4,4,"2018-19",65.1162790697674
"3548",2019-02-28,"Utah Jazz",111,"Denver Nuggets",104,19520,0,-7,7,"2018-19",79.5918367346939
"3549",2019-03-01,"Chicago Bulls",168,"Atlanta Hawks",161,15267,0,-7,7,"2018-19",41.4634146341463
"3550",2019-03-01,"Charlotte Hornets",123,"Brooklyn Nets",112,15578,0,-11,11,"2018-19",53.4883720930233
"3551",2019-03-01,"Washington Wizards",96,"Boston Celtics",107,18624,1,11,11,"2018-19",66.6666666666667
"3552",2019-03-01,"Portland Trail Blazers",117,"Toronto Raptors",119,19800,1,2,2,"2018-19",75.9259259259259
"3553",2019-03-01,"New Orleans Pelicans",130,"Phoenix Suns",116,14123,0,-14,14,"2018-19",29.2682926829268
"3554",2019-03-01,"Los Angeles Clippers",116,"Sacramento Kings",109,17583,0,-7,7,"2018-19",58.5365853658537
"3555",2019-03-01,"Milwaukee Bucks",131,"Los Angeles Lakers",120,18997,0,-11,11,"2018-19",53.6585365853659
"3556",2019-03-02,"Detroit Pistons",129,"Cleveland Cavaliers",93,19432,0,-36,36,"2018-19",31.7073170731707
"3557",2019-03-02,"Orlando Magic",117,"Indiana Pacers",112,17923,0,-5,5,"2018-19",67.4418604651163
"3558",2019-03-02,"Brooklyn Nets",88,"Miami Heat",117,19600,1,29,29,"2018-19",46.3414634146341
"3559",2019-03-02,"Memphis Grizzlies",111,"Dallas Mavericks",81,20233,0,-30,30,"2018-19",58.5365853658537
"3560",2019-03-02,"Golden State Warriors",120,"Philadelphia 76ers",117,20624,0,-3,3,"2018-19",74.468085106383
"3561",2019-03-02,"Oklahoma City Thunder",102,"San Antonio Spurs",116,18439,1,14,14,"2018-19",77.2727272727273
"3562",2019-03-02,"New Orleans Pelicans",120,"Denver Nuggets",112,19978,0,-8,8,"2018-19",79.5918367346939
"3563",2019-03-02,"Los Angeles Lakers",109,"Phoenix Suns",118,18055,1,9,9,"2018-19",29.2682926829268
"3564",2019-03-02,"Milwaukee Bucks",111,"Utah Jazz",115,18306,1,4,4,"2018-19",69.7674418604651
"3565",2019-03-03,"Portland Trail Blazers",118,"Charlotte Hornets",108,18355,0,-10,10,"2018-19",60.9756097560976
"3566",2019-03-03,"Houston Rockets",115,"Boston Celtics",104,18624,0,-11,11,"2018-19",66.6666666666667
"3567",2019-03-03,"Atlanta Hawks",123,"Chicago Bulls",118,20526,0,-5,5,"2018-19",21.9512195121951
"3568",2019-03-03,"New York Knicks",107,"Los Angeles Clippers",128,19068,1,21,21,"2018-19",59.0909090909091
"3569",2019-03-03,"Orlando Magic",93,"Cleveland Cavaliers",107,19432,1,14,14,"2018-19",31.7073170731707
"3570",2019-03-03,"Toronto Raptors",107,"Detroit Pistons",112,19161,1,5,5,"2018-19",60.4651162790698
"3571",2019-03-03,"Minnesota Timberwolves",121,"Washington Wizards",135,17869,1,14,14,"2018-19",53.6585365853659
"3572",2019-03-03,"Memphis Grizzlies",95,"Oklahoma City Thunder",99,18203,1,4,4,"2018-19",65.1162790697674
"3573",2019-03-04,"Dallas Mavericks",88,"Brooklyn Nets",127,17064,1,39,39,"2018-19",53.4883720930233
"3574",2019-03-04,"Atlanta Hawks",113,"Miami Heat",114,19600,1,1,1,"2018-19",46.3414634146341
"3575",2019-03-04,"Denver Nuggets",103,"San Antonio Spurs",104,18354,1,1,1,"2018-19",77.2727272727273
"3576",2019-03-04,"Milwaukee Bucks",105,"Phoenix Suns",114,18055,1,9,9,"2018-19",29.2682926829268
"3577",2019-03-04,"New Orleans Pelicans",115,"Utah Jazz",112,18306,0,-3,3,"2018-19",69.7674418604651
"3578",2019-03-04,"New York Knicks",108,"Sacramento Kings",115,17034,1,7,7,"2018-19",58.5365853658537
"3579",2019-03-04,"Los Angeles Clippers",113,"Los Angeles Lakers",105,18997,0,-8,8,"2018-19",53.6585365853659
"3580",2019-03-05,"Chicago Bulls",96,"Indiana Pacers",105,15753,1,9,9,"2018-19",67.4418604651163
"3581",2019-03-05,"Orlando Magic",106,"Philadelphia 76ers",114,20379,1,8,8,"2018-19",74.468085106383
"3582",2019-03-05,"Portland Trail Blazers",111,"Memphis Grizzlies",120,13801,1,9,9,"2018-19",51.219512195122
"3583",2019-03-05,"Oklahoma City Thunder",120,"Minnesota Timberwolves",131,15728,1,11,11,"2018-19",60.9756097560976
"3584",2019-03-05,"Houston Rockets",107,"Toronto Raptors",95,19800,0,-12,12,"2018-19",75.9259259259259
"3585",2019-03-05,"Boston Celtics",128,"Golden State Warriors",95,19596,0,-33,33,"2018-19",69.2307692307692
"3586",2019-03-06,"Miami Heat",91,"Charlotte Hornets",84,18137,0,-7,7,"2018-19",60.9756097560976
"3587",2019-03-06,"Minnesota Timberwolves",114,"Detroit Pistons",131,15240,1,17,17,"2018-19",60.4651162790698
"3588",2019-03-06,"Dallas Mavericks",123,"Washington Wizards",132,16867,1,9,9,"2018-19",53.6585365853659
"3589",2019-03-06,"San Antonio Spurs",111,"Atlanta Hawks",104,15208,0,-7,7,"2018-19",41.4634146341463
"3590",2019-03-06,"Cleveland Cavaliers",107,"Brooklyn Nets",113,14177,1,6,6,"2018-19",53.4883720930233
"3591",2019-03-06,"Philadelphia 76ers",107,"Chicago Bulls",108,19927,1,1,1,"2018-19",21.9512195121951
"3592",2019-03-06,"Utah Jazz",114,"New Orleans Pelicans",104,14681,0,-10,10,"2018-19",46.3414634146341
"3593",2019-03-06,"New York Knicks",96,"Phoenix Suns",107,14427,1,11,11,"2018-19",29.2682926829268
"3594",2019-03-06,"Boston Celtics",111,"Sacramento Kings",109,17583,0,-2,2,"2018-19",58.5365853658537
"3595",2019-03-06,"Denver Nuggets",115,"Los Angeles Lakers",99,18997,0,-16,16,"2018-19",53.6585365853659
"3596",2019-03-07,"Indiana Pacers",98,"Milwaukee Bucks",117,17884,1,19,19,"2018-19",79.5918367346939
"3597",2019-03-07,"Oklahoma City Thunder",129,"Portland Trail Blazers",121,20037,0,-8,8,"2018-19",75.5102040816327
"3598",2019-03-08,"Washington Wizards",111,"Charlotte Hornets",112,18144,1,1,1,"2018-19",60.9756097560976
"3599",2019-03-08,"Dallas Mavericks",106,"Orlando Magic",111,19196,1,5,5,"2018-19",58.1395348837209
"3600",2019-03-08,"Detroit Pistons",112,"Chicago Bulls",104,21048,0,-8,8,"2018-19",21.9512195121951
"3601",2019-03-08,"Philadelphia 76ers",91,"Houston Rockets",107,18055,1,16,16,"2018-19",76.5957446808511
"3602",2019-03-08,"Utah Jazz",104,"Memphis Grizzlies",114,15407,1,10,10,"2018-19",51.219512195122
"3603",2019-03-08,"Cleveland Cavaliers",110,"Miami Heat",126,19600,1,16,16,"2018-19",46.3414634146341
"3604",2019-03-08,"Toronto Raptors",127,"New Orleans Pelicans",104,17325,0,-23,23,"2018-19",46.3414634146341
"3605",2019-03-08,"Denver Nuggets",105,"Golden State Warriors",122,19596,1,17,17,"2018-19",69.2307692307692
"3606",2019-03-08,"Oklahoma City Thunder",110,"Los Angeles Clippers",118,17915,1,8,8,"2018-19",59.0909090909091
"3607",2019-03-09,"Sacramento Kings",102,"New York Knicks",94,19812,0,-8,8,"2018-19",21.9512195121951
"3608",2019-03-09,"Brooklyn Nets",114,"Atlanta Hawks",112,16527,0,-2,2,"2018-19",41.4634146341463
"3609",2019-03-09,"Washington Wizards",130,"Minnesota Timberwolves",135,14381,1,5,5,"2018-19",60.9756097560976
"3610",2019-03-09,"Boston Celtics",120,"Los Angeles Lakers",107,18997,0,-13,13,"2018-19",53.6585365853659
"3611",2019-03-09,"Charlotte Hornets",114,"Milwaukee Bucks",131,17996,1,17,17,"2018-19",79.5918367346939
"3612",2019-03-09,"Phoenix Suns",120,"Portland Trail Blazers",127,19851,1,7,7,"2018-19",75.5102040816327
"3613",2019-03-10,"Chicago Bulls",108,"Detroit Pistons",131,19356,1,23,23,"2018-19",60.4651162790698
"3614",2019-03-10,"Toronto Raptors",125,"Miami Heat",104,19600,0,-21,21,"2018-19",46.3414634146341
"3615",2019-03-10,"Indiana Pacers",89,"Philadelphia 76ers",106,20636,1,17,17,"2018-19",74.468085106383
"3616",2019-03-10,"New Orleans Pelicans",116,"Atlanta Hawks",128,14337,1,12,12,"2018-19",41.4634146341463
"3617",2019-03-10,"Orlando Magic",97,"Memphis Grizzlies",105,16627,1,8,8,"2018-19",51.219512195122
"3618",2019-03-10,"Houston Rockets",94,"Dallas Mavericks",93,20423,0,-1,1,"2018-19",58.5365853658537
"3619",2019-03-10,"New York Knicks",92,"Minnesota Timberwolves",103,13806,1,11,11,"2018-19",60.9756097560976
"3620",2019-03-10,"Milwaukee Bucks",114,"San Antonio Spurs",121,18594,1,7,7,"2018-19",77.2727272727273
"3621",2019-03-10,"Phoenix Suns",115,"Golden State Warriors",111,19596,0,-4,4,"2018-19",69.2307692307692
"3622",2019-03-11,"Toronto Raptors",101,"Cleveland Cavaliers",126,19432,1,25,25,"2018-19",31.7073170731707
"3623",2019-03-11,"Sacramento Kings",115,"Washington Wizards",121,15012,1,6,6,"2018-19",53.6585365853659
"3624",2019-03-11,"Detroit Pistons",75,"Brooklyn Nets",103,17732,1,28,28,"2018-19",53.4883720930233
"3625",2019-03-11,"Charlotte Hornets",106,"Houston Rockets",118,18055,1,12,12,"2018-19",76.5957446808511
"3626",2019-03-11,"Oklahoma City Thunder",98,"Utah Jazz",89,18306,0,-9,9,"2018-19",69.7674418604651
"3627",2019-03-11,"Boston Celtics",115,"Los Angeles Clippers",140,19068,1,25,25,"2018-19",59.0909090909091
"3628",2019-03-12,"New York Knicks",98,"Indiana Pacers",103,16679,1,5,5,"2018-19",67.4418604651163
"3629",2019-03-12,"Cleveland Cavaliers",99,"Philadelphia 76ers",106,20420,1,7,7,"2018-19",74.468085106383
"3630",2019-03-12,"Los Angeles Lakers",123,"Chicago Bulls",107,21359,0,-16,16,"2018-19",21.9512195121951
"3631",2019-03-12,"San Antonio Spurs",112,"Dallas Mavericks",105,20366,0,-7,7,"2018-19",58.5365853658537
"3632",2019-03-12,"Milwaukee Bucks",130,"New Orleans Pelicans",113,15562,0,-17,17,"2018-19",46.3414634146341
"3633",2019-03-12,"Minnesota Timberwolves",107,"Denver Nuggets",133,16874,1,26,26,"2018-19",79.5918367346939
"3634",2019-03-12,"Portland Trail Blazers",125,"Los Angeles Clippers",104,16686,0,-21,21,"2018-19",59.0909090909091
"3635",2019-03-13,"Brooklyn Nets",96,"Oklahoma City Thunder",108,18203,1,12,12,"2018-19",65.1162790697674
"3636",2019-03-13,"Orlando Magic",90,"Washington Wizards",100,15107,1,10,10,"2018-19",53.6585365853659
"3637",2019-03-13,"Memphis Grizzlies",111,"Atlanta Hawks",132,15169,1,21,21,"2018-19",41.4634146341463
"3638",2019-03-13,"Detroit Pistons",74,"Miami Heat",108,19600,1,34,34,"2018-19",46.3414634146341
"3639",2019-03-13,"Golden State Warriors",106,"Houston Rockets",104,18122,0,-2,2,"2018-19",76.5957446808511
"3640",2019-03-13,"Utah Jazz",114,"Phoenix Suns",97,18055,0,-17,17,"2018-19",29.2682926829268
"3641",2019-03-14,"Oklahoma City Thunder",106,"Indiana Pacers",108,16656,1,2,2,"2018-19",67.4418604651163
"3642",2019-03-14,"Cleveland Cavaliers",91,"Orlando Magic",120,18091,1,29,29,"2018-19",58.1395348837209
"3643",2019-03-14,"Sacramento Kings",120,"Boston Celtics",126,18624,1,6,6,"2018-19",66.6666666666667
"3644",2019-03-14,"Los Angeles Lakers",98,"Toronto Raptors",111,19962,1,13,13,"2018-19",75.9259259259259
"3645",2019-03-14,"Minnesota Timberwolves",100,"Utah Jazz",120,18306,1,20,20,"2018-19",69.7674418604651
"3646",2019-03-14,"Dallas Mavericks",99,"Denver Nuggets",100,19520,1,1,1,"2018-19",79.5918367346939
"3647",2019-03-15,"Los Angeles Lakers",97,"Detroit Pistons",111,20768,1,14,14,"2018-19",60.4651162790698
"3648",2019-03-15,"Sacramento Kings",114,"Philadelphia 76ers",123,20704,1,9,9,"2018-19",74.468085106383
"3649",2019-03-15,"Charlotte Hornets",116,"Washington Wizards",110,19520,0,-6,6,"2018-19",53.6585365853659
"3650",2019-03-15,"Phoenix Suns",102,"Houston Rockets",108,18055,1,6,6,"2018-19",76.5957446808511
"3651",2019-03-15,"Milwaukee Bucks",113,"Miami Heat",98,19600,0,-15,15,"2018-19",46.3414634146341
"3652",2019-03-15,"Portland Trail Blazers",122,"New Orleans Pelicans",110,16117,0,-12,12,"2018-19",46.3414634146341
"3653",2019-03-15,"New York Knicks",83,"San Antonio Spurs",109,18354,1,26,26,"2018-19",77.2727272727273
"3654",2019-03-15,"Chicago Bulls",121,"Los Angeles Clippers",128,17404,1,7,7,"2018-19",59.0909090909091
"3655",2019-03-16,"Atlanta Hawks",120,"Boston Celtics",129,18624,1,9,9,"2018-19",66.6666666666667
"3656",2019-03-16,"Phoenix Suns",138,"New Orleans Pelicans",136,17641,0,-2,2,"2018-19",46.3414634146341
"3657",2019-03-16,"Memphis Grizzlies",128,"Washington Wizards",135,19750,1,7,7,"2018-19",53.6585365853659
"3658",2019-03-16,"Cleveland Cavaliers",116,"Dallas Mavericks",121,20347,1,5,5,"2018-19",58.5365853658537
"3659",2019-03-16,"Golden State Warriors",110,"Oklahoma City Thunder",88,18203,0,-22,22,"2018-19",65.1162790697674
"3660",2019-03-16,"Portland Trail Blazers",103,"San Antonio Spurs",108,18354,1,5,5,"2018-19",77.2727272727273
"3661",2019-03-16,"Indiana Pacers",100,"Denver Nuggets",102,19856,1,2,2,"2018-19",79.5918367346939
"3662",2019-03-16,"Brooklyn Nets",98,"Utah Jazz",114,18306,1,16,16,"2018-19",69.7674418604651
"3663",2019-03-17,"Los Angeles Lakers",123,"New York Knicks",124,19812,1,1,1,"2018-19",21.9512195121951
"3664",2019-03-17,"Charlotte Hornets",75,"Miami Heat",93,19600,1,18,18,"2018-19",46.3414634146341
"3665",2019-03-17,"Philadelphia 76ers",130,"Milwaukee Bucks",125,18148,0,-5,5,"2018-19",79.5918367346939
"3666",2019-03-17,"Toronto Raptors",107,"Detroit Pistons",110,19277,1,3,3,"2018-19",60.4651162790698
"3667",2019-03-17,"Atlanta Hawks",91,"Orlando Magic",101,18045,1,10,10,"2018-19",58.1395348837209
"3668",2019-03-17,"Chicago Bulls",102,"Sacramento Kings",129,17583,1,27,27,"2018-19",58.5365853658537
"3669",2019-03-17,"Minnesota Timberwolves",102,"Houston Rockets",117,18055,1,15,15,"2018-19",76.5957446808511
"3670",2019-03-17,"Brooklyn Nets",116,"Los Angeles Clippers",119,17247,1,3,3,"2018-19",59.0909090909091
"3671",2019-03-18,"Detroit Pistons",119,"Cleveland Cavaliers",126,18465,1,7,7,"2018-19",31.7073170731707
"3672",2019-03-18,"Utah Jazz",116,"Washington Wizards",95,15637,0,-21,21,"2018-19",53.6585365853659
"3673",2019-03-18,"Denver Nuggets",114,"Boston Celtics",105,18624,0,-9,9,"2018-19",66.6666666666667
"3674",2019-03-18,"New York Knicks",92,"Toronto Raptors",128,19800,1,36,36,"2018-19",75.9259259259259
"3675",2019-03-18,"Miami Heat",116,"Oklahoma City Thunder",107,18203,0,-9,9,"2018-19",65.1162790697674
"3676",2019-03-18,"Golden State Warriors",105,"San Antonio Spurs",111,18354,1,6,6,"2018-19",77.2727272727273
"3677",2019-03-18,"New Orleans Pelicans",129,"Dallas Mavericks",125,20276,0,-4,4,"2018-19",58.5365853658537
"3678",2019-03-18,"Chicago Bulls",116,"Phoenix Suns",101,15879,0,-15,15,"2018-19",29.2682926829268
"3679",2019-03-18,"Indiana Pacers",98,"Portland Trail Blazers",106,19393,1,8,8,"2018-19",75.5102040816327
"3680",2019-03-19,"Philadelphia 76ers",118,"Charlotte Hornets",114,16411,0,-4,4,"2018-19",60.9756097560976
"3681",2019-03-19,"Houston Rockets",121,"Atlanta Hawks",105,16293,0,-16,16,"2018-19",41.4634146341463
"3682",2019-03-19,"Los Angeles Lakers",101,"Milwaukee Bucks",115,17879,1,14,14,"2018-19",79.5918367346939
"3683",2019-03-19,"Golden State Warriors",117,"Minnesota Timberwolves",107,17964,0,-10,10,"2018-19",60.9756097560976
"3684",2019-03-19,"Brooklyn Nets",123,"Sacramento Kings",121,17583,0,-2,2,"2018-19",58.5365853658537
"3685",2019-03-19,"Indiana Pacers",109,"Los Angeles Clippers",115,16043,1,6,6,"2018-19",59.0909090909091
"3686",2019-03-20,"Milwaukee Bucks",102,"Cleveland Cavaliers",107,19432,1,5,5,"2018-19",31.7073170731707
"3687",2019-03-20,"New Orleans Pelicans",96,"Orlando Magic",119,17005,1,23,23,"2018-19",58.1395348837209
"3688",2019-03-20,"Boston Celtics",115,"Philadelphia 76ers",118,20606,1,3,3,"2018-19",74.468085106383
"3689",2019-03-20,"Utah Jazz",137,"New York Knicks",116,18530,0,-21,21,"2018-19",21.9512195121951
"3690",2019-03-20,"Washington Wizards",120,"Chicago Bulls",126,19470,1,6,6,"2018-19",21.9512195121951
"3691",2019-03-20,"Houston Rockets",125,"Memphis Grizzlies",126,16691,1,1,1,"2018-19",51.219512195122
"3692",2019-03-20,"Miami Heat",110,"San Antonio Spurs",105,18354,0,-5,5,"2018-19",77.2727272727273
"3693",2019-03-20,"Toronto Raptors",123,"Oklahoma City Thunder",114,18203,0,-9,9,"2018-19",65.1162790697674
"3694",2019-03-20,"Dallas Mavericks",118,"Portland Trail Blazers",126,19803,1,8,8,"2018-19",75.5102040816327
"3695",2019-03-21,"Minnesota Timberwolves",106,"Charlotte Hornets",113,15576,1,7,7,"2018-19",60.9756097560976
"3696",2019-03-21,"Denver Nuggets",113,"Washington Wizards",108,15986,0,-5,5,"2018-19",53.6585365853659
"3697",2019-03-21,"Utah Jazz",114,"Atlanta Hawks",117,15569,1,3,3,"2018-19",41.4634146341463
"3698",2019-03-21,"Detroit Pistons",118,"Phoenix Suns",98,16066,0,-20,20,"2018-19",29.2682926829268
"3699",2019-03-21,"Dallas Mavericks",100,"Sacramento Kings",116,17583,1,16,16,"2018-19",58.5365853658537
"3700",2019-03-21,"Indiana Pacers",89,"Golden State Warriors",112,19596,1,23,23,"2018-19",69.2307692307692
"3701",2019-03-22,"Memphis Grizzlies",119,"Orlando Magic",123,18025,1,4,4,"2018-19",58.1395348837209
"3702",2019-03-22,"Los Angeles Clippers",110,"Cleveland Cavaliers",108,19432,0,-2,2,"2018-19",31.7073170731707
"3703",2019-03-22,"Denver Nuggets",111,"New York Knicks",93,19290,0,-18,18,"2018-19",21.9512195121951
"3704",2019-03-22,"Oklahoma City Thunder",116,"Toronto Raptors",109,20014,0,-7,7,"2018-19",75.9259259259259
"3705",2019-03-22,"San Antonio Spurs",105,"Houston Rockets",111,18055,1,6,6,"2018-19",76.5957446808511
"3706",2019-03-22,"Miami Heat",87,"Milwaukee Bucks",116,18094,1,29,29,"2018-19",79.5918367346939
"3707",2019-03-22,"Brooklyn Nets",111,"Los Angeles Lakers",106,18997,0,-5,5,"2018-19",53.6585365853659
"3708",2019-03-23,"Boston Celtics",117,"Charlotte Hornets",124,19438,1,7,7,"2018-19",60.9756097560976
"3709",2019-03-23,"Miami Heat",113,"Washington Wizards",108,20409,0,-5,5,"2018-19",53.6585365853659
"3710",2019-03-23,"Philadelphia 76ers",127,"Atlanta Hawks",129,16640,1,2,2,"2018-19",41.4634146341463
"3711",2019-03-23,"Utah Jazz",114,"Chicago Bulls",83,20506,0,-31,31,"2018-19",21.9512195121951
"3712",2019-03-23,"Minnesota Timberwolves",112,"Memphis Grizzlies",99,16977,0,-13,13,"2018-19",51.219512195122
"3713",2019-03-23,"Dallas Mavericks",126,"Golden State Warriors",91,19596,0,-35,35,"2018-19",69.2307692307692
"3714",2019-03-23,"Detroit Pistons",112,"Portland Trail Blazers",117,19815,1,5,5,"2018-19",75.5102040816327
"3715",2019-03-23,"Phoenix Suns",103,"Sacramento Kings",112,17583,1,9,9,"2018-19",58.5365853658537
"3716",2019-03-24,"Los Angeles Clippers",124,"New York Knicks",113,18263,0,-11,11,"2018-19",21.9512195121951
"3717",2019-03-24,"Cleveland Cavaliers",105,"Milwaukee Bucks",127,17930,1,22,22,"2018-19",79.5918367346939
"3718",2019-03-24,"Denver Nuggets",88,"Indiana Pacers",124,17923,1,36,36,"2018-19",67.4418604651163
"3719",2019-03-24,"Charlotte Hornets",115,"Toronto Raptors",114,19800,0,-1,1,"2018-19",75.9259259259259
"3720",2019-03-24,"Houston Rockets",113,"New Orleans Pelicans",90,17048,0,-23,23,"2018-19",46.3414634146341
"3721",2019-03-24,"San Antonio Spurs",115,"Boston Celtics",96,18624,0,-19,19,"2018-19",66.6666666666667
"3722",2019-03-24,"Detroit Pistons",114,"Golden State Warriors",121,19596,1,7,7,"2018-19",69.2307692307692
"3723",2019-03-24,"Sacramento Kings",106,"Los Angeles Lakers",111,18997,1,5,5,"2018-19",53.6585365853659
"3724",2019-03-25,"Philadelphia 76ers",98,"Orlando Magic",119,16848,1,21,21,"2018-19",58.1395348837209
"3725",2019-03-25,"Oklahoma City Thunder",103,"Memphis Grizzlies",115,15144,1,12,12,"2018-19",51.219512195122
"3726",2019-03-25,"Phoenix Suns",92,"Utah Jazz",125,18306,1,33,33,"2018-19",69.7674418604651
"3727",2019-03-25,"Brooklyn Nets",144,"Portland Trail Blazers",148,20188,1,4,4,"2018-19",75.5102040816327
"3728",2019-03-26,"San Antonio Spurs",116,"Charlotte Hornets",125,14227,1,9,9,"2018-19",60.9756097560976
"3729",2019-03-26,"Boston Celtics",116,"Cleveland Cavaliers",106,19432,0,-10,10,"2018-19",31.7073170731707
"3730",2019-03-26,"Orlando Magic",104,"Miami Heat",99,19704,0,-5,5,"2018-19",46.3414634146341
"3731",2019-03-26,"Chicago Bulls",103,"Toronto Raptors",112,19800,1,9,9,"2018-19",75.9259259259259
"3732",2019-03-26,"Houston Rockets",94,"Milwaukee Bucks",108,17910,1,14,14,"2018-19",79.5918367346939
"3733",2019-03-26,"Los Angeles Clippers",122,"Minnesota Timberwolves",111,13176,0,-11,11,"2018-19",60.9756097560976
"3734",2019-03-26,"Atlanta Hawks",130,"New Orleans Pelicans",120,14751,0,-10,10,"2018-19",46.3414634146341
"3735",2019-03-26,"Sacramento Kings",125,"Dallas Mavericks",121,20168,0,-4,4,"2018-19",58.5365853658537
"3736",2019-03-26,"Detroit Pistons",92,"Denver Nuggets",95,19520,1,3,3,"2018-19",79.5918367346939
"3737",2019-03-26,"Washington Wizards",106,"Los Angeles Lakers",124,18997,1,18,18,"2018-19",53.6585365853659
"3738",2019-03-27,"Portland Trail Blazers",118,"Chicago Bulls",98,20227,0,-20,20,"2018-19",21.9512195121951
"3739",2019-03-27,"Golden State Warriors",118,"Memphis Grizzlies",103,17794,0,-15,15,"2018-19",51.219512195122
"3740",2019-03-27,"Indiana Pacers",99,"Oklahoma City Thunder",107,18203,1,8,8,"2018-19",65.1162790697674
"3741",2019-03-27,"Washington Wizards",124,"Phoenix Suns",121,16004,0,-3,3,"2018-19",29.2682926829268
"3742",2019-03-27,"Los Angeles Lakers",100,"Utah Jazz",115,18306,1,15,15,"2018-19",69.7674418604651
"3743",2019-03-28,"Orlando Magic",98,"Detroit Pistons",115,18128,1,17,17,"2018-19",60.4651162790698
"3744",2019-03-28,"Brooklyn Nets",110,"Philadelphia 76ers",123,20547,1,13,13,"2018-19",74.468085106383
"3745",2019-03-28,"Dallas Mavericks",99,"Miami Heat",105,19851,1,6,6,"2018-19",46.3414634146341
"3746",2019-03-28,"Toronto Raptors",117,"New York Knicks",92,19812,0,-25,25,"2018-19",21.9512195121951
"3747",2019-03-28,"Denver Nuggets",85,"Houston Rockets",112,18055,1,27,27,"2018-19",76.5957446808511
"3748",2019-03-28,"Los Angeles Clippers",118,"Milwaukee Bucks",128,17922,1,10,10,"2018-19",79.5918367346939
"3749",2019-03-28,"Sacramento Kings",118,"New Orleans Pelicans",121,13976,1,3,3,"2018-19",46.3414634146341
"3750",2019-03-28,"Cleveland Cavaliers",110,"San Antonio Spurs",116,18756,1,6,6,"2018-19",77.2727272727273
"3751",2019-03-29,"Indiana Pacers",112,"Boston Celtics",114,18624,1,2,2,"2018-19",66.6666666666667
"3752",2019-03-29,"Portland Trail Blazers",118,"Atlanta Hawks",98,16182,0,-20,20,"2018-19",41.4634146341463
"3753",2019-03-29,"Golden State Warriors",130,"Minnesota Timberwolves",131,18978,1,1,1,"2018-19",60.9756097560976
"3754",2019-03-29,"Denver Nuggets",115,"Oklahoma City Thunder",105,18203,0,-10,10,"2018-19",65.1162790697674
"3755",2019-03-29,"Washington Wizards",124,"Utah Jazz",128,18306,1,4,4,"2018-19",69.7674418604651
"3756",2019-03-29,"Charlotte Hornets",115,"Los Angeles Lakers",129,18997,1,14,14,"2018-19",53.6585365853659
"3757",2019-03-30,"Cleveland Cavaliers",108,"Los Angeles Clippers",132,16439,1,24,24,"2018-19",59.0909090909091
"3758",2019-03-30,"Boston Celtics",96,"Brooklyn Nets",110,17732,1,14,14,"2018-19",53.4883720930233
"3759",2019-03-30,"Sacramento Kings",108,"Houston Rockets",119,18055,1,11,11,"2018-19",76.5957446808511
"3760",2019-03-30,"Portland Trail Blazers",90,"Detroit Pistons",99,18592,1,9,9,"2018-19",60.4651162790698
"3761",2019-03-30,"Orlando Magic",121,"Indiana Pacers",116,17923,0,-5,5,"2018-19",67.4418604651163
"3762",2019-03-30,"Miami Heat",100,"New York Knicks",92,19812,0,-8,8,"2018-19",21.9512195121951
"3763",2019-03-30,"Toronto Raptors",124,"Chicago Bulls",101,21238,0,-23,23,"2018-19",21.9512195121951
"3764",2019-03-30,"Philadelphia 76ers",118,"Minnesota Timberwolves",109,18978,0,-9,9,"2018-19",60.9756097560976
"3765",2019-03-30,"Memphis Grizzlies",120,"Phoenix Suns",115,16647,0,-5,5,"2018-19",29.2682926829268
"3766",2019-03-31,"Milwaukee Bucks",135,"Atlanta Hawks",136,16660,1,1,1,"2018-19",41.4634146341463
"3767",2019-03-31,"Dallas Mavericks",106,"Oklahoma City Thunder",103,18203,0,-3,3,"2018-19",65.1162790697674
"3768",2019-03-31,"Los Angeles Lakers",130,"New Orleans Pelicans",102,18562,0,-28,28,"2018-19",46.3414634146341
"3769",2019-03-31,"Sacramento Kings",113,"San Antonio Spurs",106,18407,0,-7,7,"2018-19",77.2727272727273
"3770",2019-03-31,"Washington Wizards",95,"Denver Nuggets",90,17356,0,-5,5,"2018-19",79.5918367346939
"3771",2019-03-31,"Charlotte Hornets",90,"Golden State Warriors",137,19596,1,47,47,"2018-19",69.2307692307692
"3772",2019-03-31,"Memphis Grizzlies",96,"Los Angeles Clippers",113,16740,1,17,17,"2018-19",59.0909090909091
"3773",2019-04-01,"Detroit Pistons",102,"Indiana Pacers",111,15760,1,9,9,"2018-19",67.4418604651163
"3774",2019-04-01,"Miami Heat",105,"Boston Celtics",110,18624,1,5,5,"2018-19",66.6666666666667
"3775",2019-04-01,"Milwaukee Bucks",131,"Brooklyn Nets",121,17732,0,-10,10,"2018-19",53.4883720930233
"3776",2019-04-01,"Chicago Bulls",105,"New York Knicks",113,18874,1,8,8,"2018-19",21.9512195121951
"3777",2019-04-01,"Orlando Magic",109,"Toronto Raptors",121,19800,1,12,12,"2018-19",75.9259259259259
"3778",2019-04-01,"Portland Trail Blazers",132,"Minnesota Timberwolves",122,11209,0,-10,10,"2018-19",60.9756097560976
"3779",2019-04-01,"Philadelphia 76ers",102,"Dallas Mavericks",122,19645,1,20,20,"2018-19",58.5365853658537
"3780",2019-04-01,"Charlotte Hornets",102,"Utah Jazz",111,18306,1,9,9,"2018-19",69.7674418604651
"3781",2019-04-01,"Cleveland Cavaliers",113,"Phoenix Suns",122,14050,1,9,9,"2018-19",29.2682926829268
"3782",2019-04-02,"Los Angeles Lakers",103,"Oklahoma City Thunder",119,18203,1,16,16,"2018-19",65.1162790697674
"3783",2019-04-02,"Atlanta Hawks",111,"San Antonio Spurs",117,18354,1,6,6,"2018-19",77.2727272727273
"3784",2019-04-02,"Houston Rockets",130,"Sacramento Kings",105,17583,0,-25,25,"2018-19",58.5365853658537
"3785",2019-04-02,"Denver Nuggets",102,"Golden State Warriors",116,19596,1,14,14,"2018-19",69.2307692307692
"3786",2019-04-03,"Indiana Pacers",108,"Detroit Pistons",89,18984,0,-19,19,"2018-19",60.4651162790698
"3787",2019-04-03,"New York Knicks",100,"Orlando Magic",114,18846,1,14,14,"2018-19",58.1395348837209
"3788",2019-04-03,"Chicago Bulls",115,"Washington Wizards",114,16616,0,-1,1,"2018-19",53.6585365853659
"3789",2019-04-03,"Philadelphia 76ers",122,"Atlanta Hawks",130,16638,1,8,8,"2018-19",41.4634146341463
"3790",2019-04-03,"Toronto Raptors",115,"Brooklyn Nets",105,17732,0,-10,10,"2018-19",53.4883720930233
"3791",2019-04-03,"Boston Celtics",112,"Miami Heat",102,19904,0,-10,10,"2018-19",46.3414634146341
"3792",2019-04-03,"Charlotte Hornets",115,"New Orleans Pelicans",109,16844,0,-6,6,"2018-19",46.3414634146341
"3793",2019-04-03,"Minnesota Timberwolves",110,"Dallas Mavericks",108,19576,0,-2,2,"2018-19",58.5365853658537
"3794",2019-04-03,"San Antonio Spurs",85,"Denver Nuggets",113,17643,1,28,28,"2018-19",79.5918367346939
"3795",2019-04-03,"Utah Jazz",118,"Phoenix Suns",97,15797,0,-21,21,"2018-19",29.2682926829268
"3796",2019-04-03,"Memphis Grizzlies",89,"Portland Trail Blazers",116,19608,1,27,27,"2018-19",75.5102040816327
"3797",2019-04-03,"Houston Rockets",135,"Los Angeles Clippers",103,17593,0,-32,32,"2018-19",59.0909090909091
"3798",2019-04-04,"Milwaukee Bucks",128,"Philadelphia 76ers",122,20701,0,-6,6,"2018-19",74.468085106383
"3799",2019-04-04,"Cleveland Cavaliers",104,"Sacramento Kings",117,17583,1,13,13,"2018-19",58.5365853658537
"3800",2019-04-04,"Golden State Warriors",108,"Los Angeles Lakers",90,18997,0,-18,18,"2018-19",53.6585365853659
"3801",2019-04-05,"Toronto Raptors",111,"Charlotte Hornets",113,18684,1,2,2,"2018-19",60.9756097560976
"3802",2019-04-05,"Atlanta Hawks",113,"Orlando Magic",149,18999,1,36,36,"2018-19",58.1395348837209
"3803",2019-04-05,"San Antonio Spurs",129,"Washington Wizards",112,20409,0,-17,17,"2018-19",53.6585365853659
"3804",2019-04-05,"New York Knicks",96,"Houston Rockets",120,18055,1,24,24,"2018-19",76.5957446808511
"3805",2019-04-05,"Boston Celtics",117,"Indiana Pacers",97,17371,0,-20,20,"2018-19",67.4418604651163
"3806",2019-04-05,"Miami Heat",109,"Minnesota Timberwolves",111,17763,1,2,2,"2018-19",60.9756097560976
"3807",2019-04-05,"Detroit Pistons",110,"Oklahoma City Thunder",123,18203,1,13,13,"2018-19",65.1162790697674
"3808",2019-04-05,"Memphis Grizzlies",122,"Dallas Mavericks",112,20111,0,-10,10,"2018-19",58.5365853658537
"3809",2019-04-05,"Sacramento Kings",98,"Utah Jazz",119,18306,1,21,21,"2018-19",69.7674418604651
"3810",2019-04-05,"New Orleans Pelicans",126,"Phoenix Suns",133,16410,1,7,7,"2018-19",29.2682926829268
"3811",2019-04-05,"Portland Trail Blazers",110,"Denver Nuggets",119,19928,1,9,9,"2018-19",79.5918367346939
"3812",2019-04-05,"Cleveland Cavaliers",114,"Golden State Warriors",120,19596,1,6,6,"2018-19",69.2307692307692
"3813",2019-04-05,"Los Angeles Lakers",122,"Los Angeles Clippers",117,17910,0,-5,5,"2018-19",59.0909090909091
"3814",2019-04-06,"Brooklyn Nets",133,"Milwaukee Bucks",128,18116,0,-5,5,"2018-19",79.5918367346939
"3815",2019-04-06,"Philadelphia 76ers",116,"Chicago Bulls",96,21059,0,-20,20,"2018-19",21.9512195121951
"3816",2019-04-07,"Miami Heat",109,"Toronto Raptors",117,19800,1,8,8,"2018-19",75.9259259259259
"3817",2019-04-07,"San Antonio Spurs",112,"Cleveland Cavaliers",90,19432,0,-22,22,"2018-19",31.7073170731707
"3818",2019-04-07,"Oklahoma City Thunder",132,"Minnesota Timberwolves",126,18978,0,-6,6,"2018-19",60.9756097560976
"3819",2019-04-07,"Charlotte Hornets",104,"Detroit Pistons",91,19871,0,-13,13,"2018-19",60.4651162790698
"3820",2019-04-07,"Brooklyn Nets",108,"Indiana Pacers",96,16197,0,-12,12,"2018-19",67.4418604651163
"3821",2019-04-07,"Dallas Mavericks",129,"Memphis Grizzlies",127,16744,0,-2,2,"2018-19",51.219512195122
"3822",2019-04-07,"Phoenix Suns",113,"Houston Rockets",149,18055,1,36,36,"2018-19",76.5957446808511
"3823",2019-04-07,"Atlanta Hawks",107,"Milwaukee Bucks",115,17775,1,8,8,"2018-19",79.5918367346939
"3824",2019-04-07,"Orlando Magic",116,"Boston Celtics",108,18624,0,-8,8,"2018-19",66.6666666666667
"3825",2019-04-07,"Washington Wizards",110,"New York Knicks",113,19812,1,3,3,"2018-19",21.9512195121951
"3826",2019-04-07,"Los Angeles Clippers",104,"Golden State Warriors",131,19596,1,27,27,"2018-19",69.2307692307692
"3827",2019-04-07,"Denver Nuggets",108,"Portland Trail Blazers",115,19890,1,7,7,"2018-19",75.5102040816327
"3828",2019-04-07,"New Orleans Pelicans",133,"Sacramento Kings",129,17583,0,-4,4,"2018-19",58.5365853658537
"3829",2019-04-07,"Utah Jazz",109,"Los Angeles Lakers",113,18997,1,4,4,"2018-19",53.6585365853659
"3830",2019-04-09,"Charlotte Hornets",124,"Cleveland Cavaliers",97,19432,0,-27,27,"2018-19",31.7073170731707
"3831",2019-04-09,"Memphis Grizzlies",93,"Detroit Pistons",100,19802,1,7,7,"2018-19",60.4651162790698
"3832",2019-04-09,"Boston Celtics",116,"Washington Wizards",110,20409,0,-6,6,"2018-19",53.6585365853659
"3833",2019-04-09,"Philadelphia 76ers",99,"Miami Heat",122,20153,1,23,23,"2018-19",46.3414634146341
"3834",2019-04-09,"New York Knicks",96,"Chicago Bulls",86,21350,0,-10,10,"2018-19",21.9512195121951
"3835",2019-04-09,"Toronto Raptors",120,"Minnesota Timberwolves",100,16119,0,-20,20,"2018-19",60.9756097560976
"3836",2019-04-09,"Golden State Warriors",112,"New Orleans Pelicans",103,17090,0,-9,9,"2018-19",46.3414634146341
"3837",2019-04-09,"Phoenix Suns",109,"Dallas Mavericks",120,21041,1,11,11,"2018-19",58.5365853658537
"3838",2019-04-09,"Denver Nuggets",108,"Utah Jazz",118,18306,1,10,10,"2018-19",69.7674418604651
"3839",2019-04-09,"Houston Rockets",111,"Oklahoma City Thunder",112,18203,1,1,1,"2018-19",65.1162790697674
"3840",2019-04-09,"Portland Trail Blazers",104,"Los Angeles Lakers",101,18997,0,-3,3,"2018-19",53.6585365853659
"3841",2019-04-10,"Indiana Pacers",135,"Atlanta Hawks",134,17143,0,-1,1,"2018-19",41.4634146341463
"3842",2019-04-10,"Miami Heat",94,"Brooklyn Nets",113,17732,1,19,19,"2018-19",53.4883720930233
"3843",2019-04-10,"Orlando Magic",122,"Charlotte Hornets",114,17719,0,-8,8,"2018-19",60.9756097560976
"3844",2019-04-10,"Golden State Warriors",117,"Memphis Grizzlies",132,17794,1,15,15,"2018-19",51.219512195122
"3845",2019-04-10,"Oklahoma City Thunder",127,"Milwaukee Bucks",116,18082,0,-11,11,"2018-19",79.5918367346939
"3846",2019-04-10,"Detroit Pistons",115,"New York Knicks",89,19812,0,-26,26,"2018-19",21.9512195121951
"3847",2019-04-10,"Chicago Bulls",109,"Philadelphia 76ers",125,20197,1,16,16,"2018-19",74.468085106383
"3848",2019-04-10,"Dallas Mavericks",94,"San Antonio Spurs",105,18629,1,11,11,"2018-19",77.2727272727273
"3849",2019-04-10,"Minnesota Timberwolves",95,"Denver Nuggets",99,16332,1,4,4,"2018-19",79.5918367346939
"3850",2019-04-10,"Utah Jazz",137,"Los Angeles Clippers",143,17655,1,6,6,"2018-19",59.0909090909091
"3851",2019-04-10,"Sacramento Kings",131,"Portland Trail Blazers",136,19814,1,5,5,"2018-19",75.5102040816327
"3852",2019-04-13,"Brooklyn Nets",111,"Philadelphia 76ers",102,20437,0,-9,9,"2018-19",74.468085106383
"3853",2019-04-13,"Orlando Magic",104,"Toronto Raptors",101,19937,0,-3,3,"2018-19",75.9259259259259
"3854",2019-04-13,"Los Angeles Clippers",104,"Golden State Warriors",121,19596,1,17,17,"2018-19",69.2307692307692
"3855",2019-04-13,"San Antonio Spurs",101,"Denver Nuggets",96,19520,0,-5,5,"2018-19",79.5918367346939
"3856",2019-04-14,"Indiana Pacers",74,"Boston Celtics",84,18624,1,10,10,"2018-19",66.6666666666667
"3857",2019-04-14,"Oklahoma City Thunder",99,"Portland Trail Blazers",104,19886,1,5,5,"2018-19",75.5102040816327
"3858",2019-04-14,"Detroit Pistons",86,"Milwaukee Bucks",121,17529,1,35,35,"2018-19",79.5918367346939
"3859",2019-04-14,"Utah Jazz",90,"Houston Rockets",122,18055,1,32,32,"2018-19",76.5957446808511
"3860",2019-04-15,"Brooklyn Nets",123,"Philadelphia 76ers",145,20591,1,22,22,"2018-19",74.468085106383
"3861",2019-04-15,"Los Angeles Clippers",135,"Golden State Warriors",131,19596,0,-4,4,"2018-19",69.2307692307692
"3862",2019-04-16,"Orlando Magic",82,"Toronto Raptors",111,19964,1,29,29,"2018-19",75.9259259259259
"3863",2019-04-16,"San Antonio Spurs",105,"Denver Nuggets",114,19520,1,9,9,"2018-19",79.5918367346939
"3864",2019-04-16,"Oklahoma City Thunder",94,"Portland Trail Blazers",114,20041,1,20,20,"2018-19",75.5102040816327
"3865",2019-04-17,"Indiana Pacers",91,"Boston Celtics",99,18624,1,8,8,"2018-19",66.6666666666667
"3866",2019-04-17,"Detroit Pistons",99,"Milwaukee Bucks",120,17513,1,21,21,"2018-19",79.5918367346939
"3867",2019-04-17,"Utah Jazz",98,"Houston Rockets",118,18055,1,20,20,"2018-19",76.5957446808511
"3868",2019-04-18,"Philadelphia 76ers",131,"Brooklyn Nets",115,17732,0,-16,16,"2018-19",53.4883720930233
"3869",2019-04-18,"Denver Nuggets",108,"San Antonio Spurs",118,18354,1,10,10,"2018-19",77.2727272727273
"3870",2019-04-18,"Golden State Warriors",132,"Los Angeles Clippers",105,19068,0,-27,27,"2018-19",59.0909090909091
"3871",2019-04-19,"Toronto Raptors",98,"Orlando Magic",93,19367,0,-5,5,"2018-19",58.1395348837209
"3872",2019-04-19,"Boston Celtics",104,"Indiana Pacers",96,17923,0,-8,8,"2018-19",67.4418604651163
"3873",2019-04-19,"Portland Trail Blazers",108,"Oklahoma City Thunder",120,18203,1,12,12,"2018-19",65.1162790697674
"3874",2019-04-20,"Philadelphia 76ers",112,"Brooklyn Nets",108,17732,0,-4,4,"2018-19",53.4883720930233
"3875",2019-04-20,"Denver Nuggets",117,"San Antonio Spurs",103,18354,0,-14,14,"2018-19",77.2727272727273
"3876",2019-04-20,"Milwaukee Bucks",119,"Detroit Pistons",103,20520,0,-16,16,"2018-19",60.4651162790698
"3877",2019-04-20,"Houston Rockets",104,"Utah Jazz",101,18306,0,-3,3,"2018-19",69.7674418604651
"3878",2019-04-21,"Boston Celtics",110,"Indiana Pacers",106,17923,0,-4,4,"2018-19",67.4418604651163
"3879",2019-04-21,"Golden State Warriors",113,"Los Angeles Clippers",105,19068,0,-8,8,"2018-19",59.0909090909091
"3880",2019-04-21,"Toronto Raptors",107,"Orlando Magic",85,19087,0,-22,22,"2018-19",58.1395348837209
"3881",2019-04-21,"Portland Trail Blazers",111,"Oklahoma City Thunder",98,18203,0,-13,13,"2018-19",65.1162790697674
"3882",2019-04-22,"Milwaukee Bucks",127,"Detroit Pistons",104,20332,0,-23,23,"2018-19",60.4651162790698
"3883",2019-04-22,"Houston Rockets",91,"Utah Jazz",107,18306,1,16,16,"2018-19",69.7674418604651
"3884",2019-04-23,"Orlando Magic",96,"Toronto Raptors",115,19800,1,19,19,"2018-19",75.9259259259259
"3885",2019-04-23,"Brooklyn Nets",100,"Philadelphia 76ers",122,20595,1,22,22,"2018-19",74.468085106383
"3886",2019-04-23,"San Antonio Spurs",90,"Denver Nuggets",108,19520,1,18,18,"2018-19",79.5918367346939
"3887",2019-04-23,"Oklahoma City Thunder",115,"Portland Trail Blazers",118,20241,1,3,3,"2018-19",75.5102040816327
"3888",2019-04-24,"Utah Jazz",93,"Houston Rockets",100,18055,1,7,7,"2018-19",76.5957446808511
"3889",2019-04-24,"Los Angeles Clippers",129,"Golden State Warriors",121,19596,0,-8,8,"2018-19",69.2307692307692
"3890",2019-04-25,"Denver Nuggets",103,"San Antonio Spurs",120,18354,1,17,17,"2018-19",77.2727272727273
"3891",2019-04-26,"Golden State Warriors",129,"Los Angeles Clippers",110,19068,0,-19,19,"2018-19",59.0909090909091
"3892",2019-04-27,"Philadelphia 76ers",95,"Toronto Raptors",108,19800,1,13,13,"2018-19",75.9259259259259
"3893",2019-04-27,"San Antonio Spurs",86,"Denver Nuggets",90,19725,1,4,4,"2018-19",79.5918367346939
"3894",2019-04-28,"Boston Celtics",112,"Milwaukee Bucks",90,17561,0,-22,22,"2018-19",79.5918367346939
"3895",2019-04-28,"Houston Rockets",100,"Golden State Warriors",104,19596,1,4,4,"2018-19",69.2307692307692
"3896",2019-04-29,"Philadelphia 76ers",94,"Toronto Raptors",89,19800,0,-5,5,"2018-19",75.9259259259259
"3897",2019-04-29,"Portland Trail Blazers",113,"Denver Nuggets",121,19520,1,8,8,"2018-19",79.5918367346939
"3898",2019-04-30,"Boston Celtics",102,"Milwaukee Bucks",123,17536,1,21,21,"2018-19",79.5918367346939
"3899",2019-04-30,"Houston Rockets",109,"Golden State Warriors",115,19596,1,6,6,"2018-19",69.2307692307692
"3900",2019-05-01,"Portland Trail Blazers",97,"Denver Nuggets",90,19520,0,-7,7,"2018-19",79.5918367346939
"3901",2019-05-02,"Toronto Raptors",95,"Philadelphia 76ers",116,20658,1,21,21,"2018-19",74.468085106383
"3902",2019-05-03,"Milwaukee Bucks",123,"Boston Celtics",116,18624,0,-7,7,"2018-19",66.6666666666667
"3903",2019-05-03,"Denver Nuggets",137,"Portland Trail Blazers",140,20193,1,3,3,"2018-19",75.5102040816327
"3904",2019-05-04,"Golden State Warriors",121,"Houston Rockets",126,18169,1,5,5,"2018-19",76.5957446808511
"3905",2019-05-05,"Toronto Raptors",101,"Philadelphia 76ers",96,20639,0,-5,5,"2018-19",74.468085106383
"3906",2019-05-05,"Denver Nuggets",116,"Portland Trail Blazers",112,20146,0,-4,4,"2018-19",75.5102040816327
"3907",2019-05-06,"Milwaukee Bucks",113,"Boston Celtics",101,18624,0,-12,12,"2018-19",66.6666666666667
"3908",2019-05-06,"Golden State Warriors",108,"Houston Rockets",112,18055,1,4,4,"2018-19",76.5957446808511
"3909",2019-05-07,"Philadelphia 76ers",89,"Toronto Raptors",125,20287,1,36,36,"2018-19",75.9259259259259
"3910",2019-05-07,"Portland Trail Blazers",98,"Denver Nuggets",124,19520,1,26,26,"2018-19",79.5918367346939
"3911",2019-05-08,"Boston Celtics",91,"Milwaukee Bucks",116,17701,1,25,25,"2018-19",79.5918367346939
"3912",2019-05-08,"Houston Rockets",99,"Golden State Warriors",104,19596,1,5,5,"2018-19",69.2307692307692
"3913",2019-05-09,"Toronto Raptors",101,"Philadelphia 76ers",112,20525,1,11,11,"2018-19",74.468085106383
"3914",2019-05-09,"Denver Nuggets",108,"Portland Trail Blazers",119,20022,1,11,11,"2018-19",75.5102040816327
"3915",2019-05-10,"Golden State Warriors",118,"Houston Rockets",113,18055,0,-5,5,"2018-19",76.5957446808511
"3916",2019-05-12,"Portland Trail Blazers",100,"Denver Nuggets",96,19725,0,-4,4,"2018-19",79.5918367346939
"3917",2019-05-12,"Philadelphia 76ers",90,"Toronto Raptors",92,20917,1,2,2,"2018-19",75.9259259259259
"3918",2019-05-14,"Portland Trail Blazers",94,"Golden State Warriors",116,19596,1,22,22,"2018-19",69.2307692307692
"3919",2019-05-15,"Toronto Raptors",100,"Milwaukee Bucks",108,17345,1,8,8,"2018-19",79.5918367346939
"3920",2019-05-16,"Portland Trail Blazers",111,"Golden State Warriors",114,19596,1,3,3,"2018-19",69.2307692307692
"3921",2019-05-17,"Toronto Raptors",103,"Milwaukee Bucks",125,17570,1,22,22,"2018-19",79.5918367346939
"3922",2019-05-18,"Golden State Warriors",110,"Portland Trail Blazers",99,20214,0,-11,11,"2018-19",75.5102040816327
"3923",2019-05-19,"Milwaukee Bucks",112,"Toronto Raptors",118,19923,1,6,6,"2018-19",75.9259259259259
"3924",2019-05-20,"Golden State Warriors",119,"Portland Trail Blazers",117,20064,0,-2,2,"2018-19",75.5102040816327
"3925",2019-05-21,"Milwaukee Bucks",102,"Toronto Raptors",120,20237,1,18,18,"2018-19",75.9259259259259
"3926",2019-05-23,"Toronto Raptors",105,"Milwaukee Bucks",99,17384,0,-6,6,"2018-19",79.5918367346939
"3927",2019-05-25,"Milwaukee Bucks",94,"Toronto Raptors",100,20478,1,6,6,"2018-19",75.9259259259259
"3928",2019-05-30,"Golden State Warriors",109,"Toronto Raptors",118,19983,1,9,9,"2018-19",75.9259259259259
"3929",2019-06-02,"Golden State Warriors",109,"Toronto Raptors",104,20014,0,-5,5,"2018-19",75.9259259259259
"3930",2019-06-05,"Toronto Raptors",123,"Golden State Warriors",109,19596,0,-14,14,"2018-19",69.2307692307692
"3931",2019-06-07,"Toronto Raptors",105,"Golden State Warriors",92,19596,0,-13,13,"2018-19",69.2307692307692
"3932",2019-06-10,"Golden State Warriors",106,"Toronto Raptors",105,20144,0,-1,1,"2018-19",75.9259259259259
"3933",2019-06-13,"Toronto Raptors",114,"Golden State Warriors",110,19596,0,-4,4,"2018-19",69.2307692307692
"3934",2019-10-22,"New Orleans Pelicans",122,"Toronto Raptors",130,20787,1,8,8,"2019-20",66.6666666666667
"3935",2019-10-22,"Los Angeles Lakers",102,"Los Angeles Clippers",112,19068,1,10,10,"2019-20",69.7674418604651
"3936",2019-10-23,"Chicago Bulls",125,"Charlotte Hornets",126,15424,1,1,1,"2019-20",32.258064516129
"3937",2019-10-23,"Detroit Pistons",119,"Indiana Pacers",110,17923,0,-9,9,"2019-20",65.7894736842105
"3938",2019-10-23,"Cleveland Cavaliers",85,"Orlando Magic",94,18846,1,9,9,"2019-20",48.6486486486487
"3939",2019-10-23,"Minnesota Timberwolves",127,"Brooklyn Nets",126,17732,0,-1,1,"2019-20",52.6315789473684
"3940",2019-10-23,"Memphis Grizzlies",101,"Miami Heat",120,19600,1,19,19,"2019-20",76.0869565217391
"3941",2019-10-23,"Boston Celtics",93,"Philadelphia 76ers",107,20422,1,14,14,"2019-20",83.7837837837838
"3942",2019-10-23,"Washington Wizards",100,"Dallas Mavericks",108,19816,1,8,8,"2019-20",51.219512195122
"3943",2019-10-23,"New York Knicks",111,"San Antonio Spurs",120,18354,1,9,9,"2019-20",55.8823529411765
"3944",2019-10-23,"Oklahoma City Thunder",95,"Utah Jazz",100,18306,1,5,5,"2019-20",65.7894736842105
"3945",2019-10-23,"Sacramento Kings",95,"Phoenix Suns",124,18055,1,29,29,"2019-20",43.5897435897436
"3946",2019-10-23,"Denver Nuggets",108,"Portland Trail Blazers",100,19991,0,-8,8,"2019-20",56.4102564102564
"3947",2019-10-24,"Atlanta Hawks",117,"Detroit Pistons",100,20338,0,-17,17,"2019-20",33.3333333333333
"3948",2019-10-24,"Milwaukee Bucks",117,"Houston Rockets",111,18055,0,-6,6,"2019-20",66.6666666666667
"3949",2019-10-24,"Los Angeles Clippers",141,"Golden State Warriors",122,18064,0,-19,19,"2019-20",23.5294117647059
"3950",2019-10-25,"Toronto Raptors",106,"Boston Celtics",112,18624,1,6,6,"2019-20",65.9090909090909
"3951",2019-10-25,"Minnesota Timberwolves",121,"Charlotte Hornets",99,14879,0,-22,22,"2019-20",32.258064516129
"3952",2019-10-25,"New York Knicks",109,"Brooklyn Nets",113,17732,1,4,4,"2019-20",52.6315789473684
"3953",2019-10-25,"Chicago Bulls",110,"Memphis Grizzlies",102,17794,0,-8,8,"2019-20",54.0540540540541
"3954",2019-10-25,"Dallas Mavericks",123,"New Orleans Pelicans",116,17027,0,-7,7,"2019-20",41.6666666666667
"3955",2019-10-25,"Washington Wizards",97,"Oklahoma City Thunder",85,18203,0,-12,12,"2019-20",65
"3956",2019-10-25,"Phoenix Suns",107,"Denver Nuggets",108,19557,1,1,1,"2019-20",67.3913043478261
"3957",2019-10-25,"Portland Trail Blazers",122,"Sacramento Kings",112,17583,0,-10,10,"2019-20",45.7142857142857
"3958",2019-10-25,"Utah Jazz",86,"Los Angeles Lakers",95,18997,1,9,9,"2019-20",72.3404255319149
"3959",2019-10-26,"Miami Heat",131,"Milwaukee Bucks",126,17467,0,-5,5,"2019-20",78.0487804878049
"3960",2019-10-26,"Philadelphia 76ers",117,"Detroit Pistons",111,16207,0,-6,6,"2019-20",33.3333333333333
"3961",2019-10-26,"Orlando Magic",99,"Atlanta Hawks",103,17078,1,4,4,"2019-20",41.1764705882353
"3962",2019-10-26,"Boston Celtics",118,"New York Knicks",95,19812,0,-23,23,"2019-20",33.3333333333333
"3963",2019-10-26,"Toronto Raptors",108,"Chicago Bulls",84,21498,0,-24,24,"2019-20",41.1764705882353
"3964",2019-10-26,"Indiana Pacers",99,"Cleveland Cavaliers",110,19432,1,11,11,"2019-20",30.5555555555556
"3965",2019-10-26,"New Orleans Pelicans",123,"Houston Rockets",126,18055,1,3,3,"2019-20",66.6666666666667
"3966",2019-10-26,"Washington Wizards",122,"San Antonio Spurs",124,18354,1,2,2,"2019-20",55.8823529411765
"3967",2019-10-26,"Sacramento Kings",81,"Utah Jazz",113,18306,1,32,32,"2019-20",65.7894736842105
"3968",2019-10-26,"Los Angeles Clippers",122,"Phoenix Suns",130,15802,1,8,8,"2019-20",43.5897435897436
"3969",2019-10-27,"Golden State Warriors",92,"Oklahoma City Thunder",120,18203,1,28,28,"2019-20",65
"3970",2019-10-27,"Brooklyn Nets",133,"Memphis Grizzlies",134,15517,1,1,1,"2019-20",54.0540540540541
"3971",2019-10-27,"Portland Trail Blazers",121,"Dallas Mavericks",119,19707,0,-2,2,"2019-20",51.219512195122
"3972",2019-10-27,"Miami Heat",109,"Minnesota Timberwolves",116,17049,1,7,7,"2019-20",25
"3973",2019-10-27,"Charlotte Hornets",101,"Los Angeles Lakers",120,18997,1,19,19,"2019-20",72.3404255319149
"3974",2019-10-28,"Chicago Bulls",98,"New York Knicks",105,19812,1,7,7,"2019-20",33.3333333333333
"3975",2019-10-28,"Indiana Pacers",94,"Detroit Pistons",96,13565,1,2,2,"2019-20",33.3333333333333
"3976",2019-10-28,"Orlando Magic",95,"Toronto Raptors",104,19800,1,9,9,"2019-20",66.6666666666667
"3977",2019-10-28,"Philadelphia 76ers",105,"Atlanta Hawks",103,14094,0,-2,2,"2019-20",41.1764705882353
"3978",2019-10-28,"Oklahoma City Thunder",112,"Houston Rockets",116,18055,1,4,4,"2019-20",66.6666666666667
"3979",2019-10-28,"Cleveland Cavaliers",112,"Milwaukee Bucks",129,17385,1,17,17,"2019-20",78.0487804878049
"3980",2019-10-28,"Golden State Warriors",134,"New Orleans Pelicans",123,17307,0,-11,11,"2019-20",41.6666666666667
"3981",2019-10-28,"Portland Trail Blazers",110,"San Antonio Spurs",113,18083,1,3,3,"2019-20",55.8823529411765
"3982",2019-10-28,"Utah Jazz",96,"Phoenix Suns",95,14805,0,-1,1,"2019-20",43.5897435897436
"3983",2019-10-28,"Denver Nuggets",101,"Sacramento Kings",94,15870,0,-7,7,"2019-20",45.7142857142857
"3984",2019-10-28,"Charlotte Hornets",96,"Los Angeles Clippers",111,19068,1,15,15,"2019-20",69.7674418604651
"3985",2019-10-29,"Atlanta Hawks",97,"Miami Heat",112,19600,1,15,15,"2019-20",76.0869565217391
"3986",2019-10-29,"Dallas Mavericks",109,"Denver Nuggets",106,16605,0,-3,3,"2019-20",67.3913043478261
"3987",2019-10-29,"Memphis Grizzlies",91,"Los Angeles Lakers",120,18997,1,29,29,"2019-20",72.3404255319149
"3988",2019-10-30,"Chicago Bulls",111,"Cleveland Cavaliers",117,17595,1,6,6,"2019-20",30.5555555555556
"3989",2019-10-30,"New York Knicks",83,"Orlando Magic",95,17456,1,12,12,"2019-20",48.6486486486487
"3990",2019-10-30,"Minnesota Timberwolves",95,"Philadelphia 76ers",117,20204,1,22,22,"2019-20",83.7837837837838
"3991",2019-10-30,"Milwaukee Bucks",105,"Boston Celtics",116,18624,1,11,11,"2019-20",65.9090909090909
"3992",2019-10-30,"Indiana Pacers",118,"Brooklyn Nets",108,17083,0,-10,10,"2019-20",52.6315789473684
"3993",2019-10-30,"Detroit Pistons",113,"Toronto Raptors",125,19800,1,12,12,"2019-20",66.6666666666667
"3994",2019-10-30,"Portland Trail Blazers",102,"Oklahoma City Thunder",99,18203,0,-3,3,"2019-20",65
"3995",2019-10-30,"Houston Rockets",159,"Washington Wizards",158,20476,0,-1,1,"2019-20",44.4444444444444
"3996",2019-10-30,"Charlotte Hornets",118,"Sacramento Kings",111,15416,0,-7,7,"2019-20",45.7142857142857
"3997",2019-10-30,"Los Angeles Clippers",96,"Utah Jazz",110,18306,1,14,14,"2019-20",65.7894736842105
"3998",2019-10-30,"Phoenix Suns",121,"Golden State Warriors",110,18064,0,-11,11,"2019-20",23.5294117647059
"3999",2019-10-31,"Miami Heat",106,"Atlanta Hawks",97,16539,0,-9,9,"2019-20",41.1764705882353
"4000",2019-10-31,"Denver Nuggets",107,"New Orleans Pelicans",122,16613,1,15,15,"2019-20",41.6666666666667
"4001",2019-10-31,"San Antonio Spurs",97,"Los Angeles Clippers",103,19068,1,6,6,"2019-20",69.7674418604651
"4002",2019-11-01,"Houston Rockets",116,"Brooklyn Nets",123,17732,1,7,7,"2019-20",52.6315789473684
"4003",2019-11-01,"Cleveland Cavaliers",95,"Indiana Pacers",102,16079,1,7,7,"2019-20",65.7894736842105
"4004",2019-11-01,"Milwaukee Bucks",123,"Orlando Magic",91,15105,0,-32,32,"2019-20",48.6486486486487
"4005",2019-11-01,"New York Knicks",102,"Boston Celtics",104,18624,1,2,2,"2019-20",65.9090909090909
"4006",2019-11-01,"Detroit Pistons",106,"Chicago Bulls",112,20671,1,6,6,"2019-20",41.1764705882353
"4007",2019-11-01,"Los Angeles Lakers",119,"Dallas Mavericks",110,20358,0,-9,9,"2019-20",51.219512195122
"4008",2019-11-01,"Utah Jazz",101,"Sacramento Kings",102,16273,1,1,1,"2019-20",45.7142857142857
"4009",2019-11-01,"San Antonio Spurs",127,"Golden State Warriors",110,18064,0,-17,17,"2019-20",23.5294117647059
"4010",2019-11-02,"New Orleans Pelicans",104,"Oklahoma City Thunder",115,18203,1,11,11,"2019-20",65
"4011",2019-11-02,"Brooklyn Nets",109,"Detroit Pistons",113,17222,1,4,4,"2019-20",33.3333333333333
"4012",2019-11-02,"Denver Nuggets",91,"Orlando Magic",87,17025,0,-4,4,"2019-20",48.6486486486487
"4013",2019-11-02,"Phoenix Suns",114,"Memphis Grizzlies",105,14144,0,-9,9,"2019-20",54.0540540540541
"4014",2019-11-02,"Toronto Raptors",105,"Milwaukee Bucks",115,17637,1,10,10,"2019-20",78.0487804878049
"4015",2019-11-02,"Minnesota Timberwolves",131,"Washington Wizards",109,15150,0,-22,22,"2019-20",44.4444444444444
"4016",2019-11-02,"Charlotte Hornets",93,"Golden State Warriors",87,18064,0,-6,6,"2019-20",23.5294117647059
"4017",2019-11-02,"Philadelphia 76ers",129,"Portland Trail Blazers",128,19669,0,-1,1,"2019-20",56.4102564102564
"4018",2019-11-03,"Chicago Bulls",95,"Indiana Pacers",108,17073,1,13,13,"2019-20",65.7894736842105
"4019",2019-11-03,"Houston Rockets",100,"Miami Heat",129,19724,1,29,29,"2019-20",76.0869565217391
"4020",2019-11-03,"Sacramento Kings",113,"New York Knicks",92,19812,0,-21,21,"2019-20",33.3333333333333
"4021",2019-11-03,"Los Angeles Lakers",103,"San Antonio Spurs",96,18610,0,-7,7,"2019-20",55.8823529411765
"4022",2019-11-03,"Dallas Mavericks",131,"Cleveland Cavaliers",111,18078,0,-20,20,"2019-20",30.5555555555556
"4023",2019-11-03,"Utah Jazz",94,"Los Angeles Clippers",105,19068,1,11,11,"2019-20",69.7674418604651
"4024",2019-11-04,"Detroit Pistons",99,"Washington Wizards",115,13052,1,16,16,"2019-20",44.4444444444444
"4025",2019-11-04,"New Orleans Pelicans",125,"Brooklyn Nets",135,17194,1,10,10,"2019-20",52.6315789473684
"4026",2019-11-04,"Houston Rockets",107,"Memphis Grizzlies",100,14197,0,-7,7,"2019-20",54.0540540540541
"4027",2019-11-04,"Milwaukee Bucks",134,"Minnesota Timberwolves",106,16271,0,-28,28,"2019-20",25
"4028",2019-11-04,"Philadelphia 76ers",109,"Phoenix Suns",114,14285,1,5,5,"2019-20",43.5897435897436
"4029",2019-11-04,"Portland Trail Blazers",118,"Golden State Warriors",127,18064,1,9,9,"2019-20",23.5294117647059
"4030",2019-11-05,"Indiana Pacers",120,"Charlotte Hornets",122,13341,1,2,2,"2019-20",32.258064516129
"4031",2019-11-05,"Boston Celtics",119,"Cleveland Cavaliers",113,17709,0,-6,6,"2019-20",30.5555555555556
"4032",2019-11-05,"San Antonio Spurs",100,"Atlanta Hawks",108,14025,1,8,8,"2019-20",41.1764705882353
"4033",2019-11-05,"Los Angeles Lakers",118,"Chicago Bulls",112,21193,0,-6,6,"2019-20",41.1764705882353
"4034",2019-11-05,"Orlando Magic",94,"Oklahoma City Thunder",102,18203,1,8,8,"2019-20",65
"4035",2019-11-05,"Miami Heat",89,"Denver Nuggets",109,18010,1,20,20,"2019-20",67.3913043478261
"4036",2019-11-06,"New York Knicks",102,"Detroit Pistons",122,15463,1,20,20,"2019-20",33.3333333333333
"4037",2019-11-06,"Washington Wizards",106,"Indiana Pacers",121,16171,1,15,15,"2019-20",65.7894736842105
"4038",2019-11-06,"Chicago Bulls",113,"Atlanta Hawks",93,15049,0,-20,20,"2019-20",41.1764705882353
"4039",2019-11-06,"Golden State Warriors",112,"Houston Rockets",129,18055,1,17,17,"2019-20",66.6666666666667
"4040",2019-11-06,"Sacramento Kings",120,"Toronto Raptors",124,19800,1,4,4,"2019-20",66.6666666666667
"4041",2019-11-06,"Minnesota Timberwolves",121,"Memphis Grizzlies",137,13503,1,16,16,"2019-20",54.0540540540541
"4042",2019-11-06,"Orlando Magic",106,"Dallas Mavericks",107,19487,1,1,1,"2019-20",51.219512195122
"4043",2019-11-06,"Philadelphia 76ers",104,"Utah Jazz",106,18306,1,2,2,"2019-20",65.7894736842105
"4044",2019-11-06,"Milwaukee Bucks",129,"Los Angeles Clippers",124,19068,0,-5,5,"2019-20",69.7674418604651
"4045",2019-11-07,"Boston Celtics",108,"Charlotte Hornets",87,18487,0,-21,21,"2019-20",32.258064516129
"4046",2019-11-07,"Oklahoma City Thunder",112,"San Antonio Spurs",121,18354,1,9,9,"2019-20",55.8823529411765
"4047",2019-11-07,"Miami Heat",124,"Phoenix Suns",108,15498,0,-16,16,"2019-20",43.5897435897436
"4048",2019-11-07,"Portland Trail Blazers",101,"Los Angeles Clippers",107,19068,1,6,6,"2019-20",69.7674418604651
"4049",2019-11-08,"Detroit Pistons",106,"Indiana Pacers",112,15544,1,6,6,"2019-20",65.7894736842105
"4050",2019-11-08,"Memphis Grizzlies",86,"Orlando Magic",118,17021,1,32,32,"2019-20",48.6486486486487
"4051",2019-11-08,"Cleveland Cavaliers",113,"Washington Wizards",100,16946,0,-13,13,"2019-20",44.4444444444444
"4052",2019-11-08,"Sacramento Kings",121,"Atlanta Hawks",109,16447,0,-12,12,"2019-20",41.1764705882353
"4053",2019-11-08,"Golden State Warriors",119,"Minnesota Timberwolves",125,15647,1,6,6,"2019-20",25
"4054",2019-11-08,"Toronto Raptors",122,"New Orleans Pelicans",104,16337,0,-18,18,"2019-20",41.6666666666667
"4055",2019-11-08,"New York Knicks",106,"Dallas Mavericks",102,20257,0,-4,4,"2019-20",51.219512195122
"4056",2019-11-08,"Philadelphia 76ers",97,"Denver Nuggets",100,19520,1,3,3,"2019-20",67.3913043478261
"4057",2019-11-08,"Milwaukee Bucks",100,"Utah Jazz",103,18306,1,3,3,"2019-20",65.7894736842105
"4058",2019-11-08,"Brooklyn Nets",119,"Portland Trail Blazers",115,20089,0,-4,4,"2019-20",56.4102564102564
"4059",2019-11-08,"Miami Heat",80,"Los Angeles Lakers",95,18997,1,15,15,"2019-20",72.3404255319149
"4060",2019-11-09,"Boston Celtics",135,"San Antonio Spurs",115,18354,0,-20,20,"2019-20",55.8823529411765
"4061",2019-11-09,"New Orleans Pelicans",115,"Charlotte Hornets",110,18513,0,-5,5,"2019-20",32.258064516129
"4062",2019-11-09,"Houston Rockets",117,"Chicago Bulls",94,20482,0,-23,23,"2019-20",41.1764705882353
"4063",2019-11-09,"Dallas Mavericks",138,"Memphis Grizzlies",122,15753,0,-16,16,"2019-20",54.0540540540541
"4064",2019-11-09,"Golden State Warriors",108,"Oklahoma City Thunder",114,18203,1,6,6,"2019-20",65
"4065",2019-11-10,"Denver Nuggets",100,"Minnesota Timberwolves",98,13553,0,-2,2,"2019-20",25
"4066",2019-11-10,"Indiana Pacers",109,"Orlando Magic",102,17118,0,-7,7,"2019-20",48.6486486486487
"4067",2019-11-10,"Charlotte Hornets",106,"Philadelphia 76ers",114,20311,1,8,8,"2019-20",83.7837837837838
"4068",2019-11-10,"Milwaukee Bucks",121,"Oklahoma City Thunder",119,18203,0,-2,2,"2019-20",65
"4069",2019-11-10,"Cleveland Cavaliers",108,"New York Knicks",87,19812,0,-21,21,"2019-20",33.3333333333333
"4070",2019-11-10,"Brooklyn Nets",112,"Phoenix Suns",138,17290,1,26,26,"2019-20",43.5897435897436
"4071",2019-11-10,"Atlanta Hawks",113,"Portland Trail Blazers",124,20041,1,11,11,"2019-20",56.4102564102564
"4072",2019-11-10,"Toronto Raptors",113,"Los Angeles Lakers",104,18997,0,-9,9,"2019-20",72.3404255319149
"4073",2019-11-11,"Minnesota Timberwolves",120,"Detroit Pistons",114,12526,0,-6,6,"2019-20",33.3333333333333
"4074",2019-11-11,"Dallas Mavericks",106,"Boston Celtics",116,18624,1,10,10,"2019-20",65.9090909090909
"4075",2019-11-11,"Memphis Grizzlies",113,"San Antonio Spurs",109,18627,0,-4,4,"2019-20",55.8823529411765
"4076",2019-11-11,"Houston Rockets",122,"New Orleans Pelicans",116,16695,0,-6,6,"2019-20",41.6666666666667
"4077",2019-11-11,"Utah Jazz",122,"Golden State Warriors",108,18064,0,-14,14,"2019-20",23.5294117647059
"4078",2019-11-11,"Toronto Raptors",88,"Los Angeles Clippers",98,19068,1,10,10,"2019-20",69.7674418604651
"4079",2019-11-12,"Oklahoma City Thunder",85,"Indiana Pacers",111,15838,1,26,26,"2019-20",65.7894736842105
"4080",2019-11-12,"Cleveland Cavaliers",97,"Philadelphia 76ers",98,20294,1,1,1,"2019-20",83.7837837837838
"4081",2019-11-12,"Detroit Pistons",108,"Miami Heat",117,19600,1,9,9,"2019-20",76.0869565217391
"4082",2019-11-12,"New York Knicks",102,"Chicago Bulls",120,18668,1,18,18,"2019-20",41.1764705882353
"4083",2019-11-12,"Atlanta Hawks",125,"Denver Nuggets",121,18327,0,-4,4,"2019-20",67.3913043478261
"4084",2019-11-12,"Los Angeles Lakers",123,"Phoenix Suns",115,18055,0,-8,8,"2019-20",43.5897435897436
"4085",2019-11-12,"Brooklyn Nets",114,"Utah Jazz",119,18306,1,5,5,"2019-20",65.7894736842105
"4086",2019-11-12,"Portland Trail Blazers",99,"Sacramento Kings",107,16358,1,8,8,"2019-20",45.7142857142857
"4087",2019-11-13,"Memphis Grizzlies",119,"Charlotte Hornets",117,13155,0,-2,2,"2019-20",32.258064516129
"4088",2019-11-13,"Philadelphia 76ers",97,"Orlando Magic",112,15113,1,15,15,"2019-20",48.6486486486487
"4089",2019-11-13,"Washington Wizards",133,"Boston Celtics",140,19156,1,7,7,"2019-20",65.9090909090909
"4090",2019-11-13,"Los Angeles Clippers",93,"Houston Rockets",102,18055,1,9,9,"2019-20",66.6666666666667
"4091",2019-11-13,"San Antonio Spurs",114,"Minnesota Timberwolves",129,11581,1,15,15,"2019-20",25
"4092",2019-11-13,"Golden State Warriors",94,"Los Angeles Lakers",120,18997,1,26,26,"2019-20",72.3404255319149
"4093",2019-11-13,"Toronto Raptors",114,"Portland Trail Blazers",106,19544,0,-8,8,"2019-20",56.4102564102564
"4094",2019-11-14,"Miami Heat",108,"Cleveland Cavaliers",97,17374,0,-11,11,"2019-20",30.5555555555556
"4095",2019-11-14,"Chicago Bulls",115,"Milwaukee Bucks",124,17627,1,9,9,"2019-20",78.0487804878049
"4096",2019-11-14,"Los Angeles Clippers",127,"New Orleans Pelicans",132,17147,1,5,5,"2019-20",41.6666666666667
"4097",2019-11-14,"Dallas Mavericks",103,"New York Knicks",106,19812,1,3,3,"2019-20",33.3333333333333
"4098",2019-11-14,"Atlanta Hawks",112,"Phoenix Suns",128,15143,1,16,16,"2019-20",43.5897435897436
"4099",2019-11-14,"Brooklyn Nets",93,"Denver Nuggets",101,18394,1,8,8,"2019-20",67.3913043478261
"4100",2019-11-15,"Detroit Pistons",106,"Charlotte Hornets",109,16778,1,3,3,"2019-20",32.258064516129
"4101",2019-11-15,"San Antonio Spurs",109,"Orlando Magic",111,16296,1,2,2,"2019-20",48.6486486486487
"4102",2019-11-15,"Indiana Pacers",102,"Houston Rockets",111,18055,1,9,9,"2019-20",66.6666666666667
"4103",2019-11-15,"Utah Jazz",106,"Memphis Grizzlies",107,16422,1,1,1,"2019-20",54.0540540540541
"4104",2019-11-15,"Washington Wizards",137,"Minnesota Timberwolves",116,12716,0,-21,21,"2019-20",25
"4105",2019-11-15,"Philadelphia 76ers",119,"Oklahoma City Thunder",127,18203,1,8,8,"2019-20",65
"4106",2019-11-15,"Boston Celtics",105,"Golden State Warriors",100,18064,0,-5,5,"2019-20",23.5294117647059
"4107",2019-11-15,"Sacramento Kings",97,"Los Angeles Lakers",99,18997,1,2,2,"2019-20",72.3404255319149
"4108",2019-11-16,"Brooklyn Nets",117,"Chicago Bulls",111,19148,0,-6,6,"2019-20",41.1764705882353
"4109",2019-11-16,"Milwaukee Bucks",102,"Indiana Pacers",83,17024,0,-19,19,"2019-20",65.7894736842105
"4110",2019-11-16,"Charlotte Hornets",103,"New York Knicks",102,19401,0,-1,1,"2019-20",33.3333333333333
"4111",2019-11-16,"New Orleans Pelicans",94,"Miami Heat",109,19600,1,15,15,"2019-20",76.0869565217391
"4112",2019-11-16,"Houston Rockets",125,"Minnesota Timberwolves",105,18978,0,-20,20,"2019-20",25
"4113",2019-11-16,"Toronto Raptors",102,"Dallas Mavericks",110,19926,1,8,8,"2019-20",51.219512195122
"4114",2019-11-16,"Portland Trail Blazers",121,"San Antonio Spurs",116,18534,0,-5,5,"2019-20",55.8823529411765
"4115",2019-11-16,"Atlanta Hawks",101,"Los Angeles Clippers",150,19068,1,49,49,"2019-20",69.7674418604651
"4116",2019-11-17,"Philadelphia 76ers",114,"Cleveland Cavaliers",95,19432,0,-19,19,"2019-20",30.5555555555556
"4117",2019-11-17,"Boston Celtics",99,"Sacramento Kings",100,16633,1,1,1,"2019-20",45.7142857142857
"4118",2019-11-17,"Denver Nuggets",131,"Memphis Grizzlies",114,14227,0,-17,17,"2019-20",54.0540540540541
"4119",2019-11-17,"Washington Wizards",121,"Orlando Magic",125,16344,1,4,4,"2019-20",48.6486486486487
"4120",2019-11-17,"Golden State Warriors",100,"New Orleans Pelicans",108,16812,1,8,8,"2019-20",41.6666666666667
"4121",2019-11-17,"Atlanta Hawks",101,"Los Angeles Lakers",122,18997,1,21,21,"2019-20",72.3404255319149
"4122",2019-11-18,"Cleveland Cavaliers",105,"New York Knicks",123,17097,1,18,18,"2019-20",33.3333333333333
"4123",2019-11-18,"Indiana Pacers",115,"Brooklyn Nets",86,14140,0,-29,29,"2019-20",52.6315789473684
"4124",2019-11-18,"Charlotte Hornets",96,"Toronto Raptors",132,19800,1,36,36,"2019-20",66.6666666666667
"4125",2019-11-18,"Milwaukee Bucks",115,"Chicago Bulls",101,17565,0,-14,14,"2019-20",41.1764705882353
"4126",2019-11-18,"Portland Trail Blazers",108,"Houston Rockets",132,18055,1,24,24,"2019-20",66.6666666666667
"4127",2019-11-18,"San Antonio Spurs",110,"Dallas Mavericks",117,19637,1,7,7,"2019-20",51.219512195122
"4128",2019-11-18,"Boston Celtics",99,"Phoenix Suns",85,15193,0,-14,14,"2019-20",43.5897435897436
"4129",2019-11-18,"Minnesota Timberwolves",112,"Utah Jazz",102,18306,0,-10,10,"2019-20",65.7894736842105
"4130",2019-11-18,"Oklahoma City Thunder",88,"Los Angeles Clippers",90,19068,1,2,2,"2019-20",69.7674418604651
"4131",2019-11-19,"Golden State Warriors",114,"Memphis Grizzlies",95,14511,0,-19,19,"2019-20",54.0540540540541
"4132",2019-11-19,"Portland Trail Blazers",104,"New Orleans Pelicans",115,15021,1,11,11,"2019-20",41.6666666666667
"4133",2019-11-19,"Phoenix Suns",116,"Sacramento Kings",120,16732,1,4,4,"2019-20",45.7142857142857
"4134",2019-11-19,"Oklahoma City Thunder",107,"Los Angeles Lakers",112,18997,1,5,5,"2019-20",72.3404255319149
"4135",2019-11-20,"New York Knicks",104,"Philadelphia 76ers",109,20384,1,5,5,"2019-20",83.7837837837838
"4136",2019-11-20,"San Antonio Spurs",132,"Washington Wizards",138,14579,1,6,6,"2019-20",44.4444444444444
"4137",2019-11-20,"Milwaukee Bucks",135,"Atlanta Hawks",127,16441,0,-8,8,"2019-20",41.1764705882353
"4138",2019-11-20,"Charlotte Hornets",91,"Brooklyn Nets",101,14011,1,10,10,"2019-20",52.6315789473684
"4139",2019-11-20,"Golden State Warriors",94,"Dallas Mavericks",142,19569,1,48,48,"2019-20",51.219512195122
"4140",2019-11-20,"Cleveland Cavaliers",100,"Miami Heat",124,19600,1,24,24,"2019-20",76.0869565217391
"4141",2019-11-20,"Orlando Magic",97,"Toronto Raptors",113,19800,1,16,16,"2019-20",66.6666666666667
"4142",2019-11-20,"Detroit Pistons",89,"Chicago Bulls",109,18119,1,20,20,"2019-20",41.1764705882353
"4143",2019-11-20,"Utah Jazz",103,"Minnesota Timberwolves",95,13177,0,-8,8,"2019-20",25
"4144",2019-11-20,"Houston Rockets",95,"Denver Nuggets",105,17778,1,10,10,"2019-20",67.3913043478261
"4145",2019-11-20,"Boston Celtics",104,"Los Angeles Clippers",107,19068,1,3,3,"2019-20",69.7674418604651
"4146",2019-11-21,"Portland Trail Blazers",129,"Milwaukee Bucks",137,17385,1,8,8,"2019-20",78.0487804878049
"4147",2019-11-21,"New Orleans Pelicans",124,"Phoenix Suns",121,13903,0,-3,3,"2019-20",43.5897435897436
"4148",2019-11-22,"Atlanta Hawks",103,"Detroit Pistons",128,15399,1,25,25,"2019-20",33.3333333333333
"4149",2019-11-22,"Charlotte Hornets",118,"Washington Wizards",125,15053,1,7,7,"2019-20",44.4444444444444
"4150",2019-11-22,"Sacramento Kings",97,"Brooklyn Nets",116,15619,1,19,19,"2019-20",52.6315789473684
"4151",2019-11-22,"Miami Heat",116,"Chicago Bulls",108,18953,0,-8,8,"2019-20",41.1764705882353
"4152",2019-11-22,"Los Angeles Lakers",130,"Oklahoma City Thunder",127,18203,0,-3,3,"2019-20",65
"4153",2019-11-22,"San Antonio Spurs",104,"Philadelphia 76ers",115,20927,1,11,11,"2019-20",83.7837837837838
"4154",2019-11-22,"Cleveland Cavaliers",101,"Dallas Mavericks",143,19639,1,42,42,"2019-20",51.219512195122
"4155",2019-11-22,"Boston Celtics",92,"Denver Nuggets",96,19520,1,4,4,"2019-20",67.3913043478261
"4156",2019-11-22,"Golden State Warriors",109,"Utah Jazz",113,18306,1,4,4,"2019-20",65.7894736842105
"4157",2019-11-22,"Houston Rockets",119,"Los Angeles Clippers",122,19068,1,3,3,"2019-20",69.7674418604651
"4158",2019-11-23,"Phoenix Suns",100,"Minnesota Timberwolves",98,17362,0,-2,2,"2019-20",25
"4159",2019-11-23,"Chicago Bulls",116,"Charlotte Hornets",115,17891,0,-1,1,"2019-20",32.258064516129
"4160",2019-11-23,"Orlando Magic",106,"Indiana Pacers",111,16446,1,5,5,"2019-20",65.7894736842105
"4161",2019-11-23,"Toronto Raptors",119,"Atlanta Hawks",116,16931,0,-3,3,"2019-20",41.1764705882353
"4162",2019-11-23,"San Antonio Spurs",111,"New York Knicks",104,19320,0,-7,7,"2019-20",33.3333333333333
"4163",2019-11-23,"Miami Heat",86,"Philadelphia 76ers",113,21017,1,27,27,"2019-20",83.7837837837838
"4164",2019-11-23,"Portland Trail Blazers",104,"Cleveland Cavaliers",110,19432,1,6,6,"2019-20",30.5555555555556
"4165",2019-11-23,"Los Angeles Lakers",109,"Memphis Grizzlies",108,17794,0,-1,1,"2019-20",54.0540540540541
"4166",2019-11-23,"Detroit Pistons",90,"Milwaukee Bucks",104,17585,1,14,14,"2019-20",78.0487804878049
"4167",2019-11-23,"New Orleans Pelicans",120,"Utah Jazz",128,18306,1,8,8,"2019-20",65.7894736842105
"4168",2019-11-24,"Dallas Mavericks",137,"Houston Rockets",123,18055,0,-14,14,"2019-20",66.6666666666667
"4169",2019-11-24,"Brooklyn Nets",103,"New York Knicks",101,18770,0,-2,2,"2019-20",33.3333333333333
"4170",2019-11-24,"Sacramento Kings",113,"Washington Wizards",106,15885,0,-7,7,"2019-20",44.4444444444444
"4171",2019-11-24,"Phoenix Suns",104,"Denver Nuggets",116,19520,1,12,12,"2019-20",67.3913043478261
"4172",2019-11-24,"New Orleans Pelicans",109,"Los Angeles Clippers",134,19068,1,25,25,"2019-20",69.7674418604651
"4173",2019-11-25,"Brooklyn Nets",108,"Cleveland Cavaliers",106,17143,0,-2,2,"2019-20",30.5555555555556
"4174",2019-11-25,"Orlando Magic",88,"Detroit Pistons",103,14695,1,15,15,"2019-20",33.3333333333333
"4175",2019-11-25,"Memphis Grizzlies",114,"Indiana Pacers",126,15141,1,12,12,"2019-20",65.7894736842105
"4176",2019-11-25,"Minnesota Timberwolves",125,"Atlanta Hawks",113,16218,0,-12,12,"2019-20",41.1764705882353
"4177",2019-11-25,"Sacramento Kings",102,"Boston Celtics",103,19156,1,1,1,"2019-20",65.9090909090909
"4178",2019-11-25,"Charlotte Hornets",100,"Miami Heat",117,19600,1,17,17,"2019-20",76.0869565217391
"4179",2019-11-25,"Philadelphia 76ers",96,"Toronto Raptors",101,19800,1,5,5,"2019-20",66.6666666666667
"4180",2019-11-25,"Portland Trail Blazers",117,"Chicago Bulls",94,18776,0,-23,23,"2019-20",41.1764705882353
"4181",2019-11-25,"Utah Jazz",118,"Milwaukee Bucks",122,17385,1,4,4,"2019-20",78.0487804878049
"4182",2019-11-25,"Los Angeles Lakers",114,"San Antonio Spurs",104,18498,0,-10,10,"2019-20",55.8823529411765
"4183",2019-11-25,"Oklahoma City Thunder",100,"Golden State Warriors",97,18064,0,-3,3,"2019-20",23.5294117647059
"4184",2019-11-26,"Los Angeles Clippers",114,"Dallas Mavericks",99,20407,0,-15,15,"2019-20",51.219512195122
"4185",2019-11-26,"Washington Wizards",104,"Denver Nuggets",117,18673,1,13,13,"2019-20",67.3913043478261
"4186",2019-11-27,"Brooklyn Nets",110,"Boston Celtics",121,19156,1,11,11,"2019-20",65.9090909090909
"4187",2019-11-27,"Detroit Pistons",101,"Charlotte Hornets",102,15535,1,1,1,"2019-20",32.258064516129
"4188",2019-11-27,"Orlando Magic",116,"Cleveland Cavaliers",104,17712,0,-12,12,"2019-20",30.5555555555556
"4189",2019-11-27,"Utah Jazz",102,"Indiana Pacers",121,17027,1,19,19,"2019-20",65.7894736842105
"4190",2019-11-27,"Sacramento Kings",91,"Philadelphia 76ers",97,20592,1,6,6,"2019-20",83.7837837837838
"4191",2019-11-27,"New York Knicks",98,"Toronto Raptors",126,19800,1,28,28,"2019-20",66.6666666666667
"4192",2019-11-27,"Miami Heat",108,"Houston Rockets",117,18055,1,9,9,"2019-20",66.6666666666667
"4193",2019-11-27,"Los Angeles Clippers",121,"Memphis Grizzlies",119,16721,0,-2,2,"2019-20",54.0540540540541
"4194",2019-11-27,"Atlanta Hawks",102,"Milwaukee Bucks",111,17525,1,9,9,"2019-20",78.0487804878049
"4195",2019-11-27,"Minnesota Timberwolves",113,"San Antonio Spurs",101,18354,0,-12,12,"2019-20",55.8823529411765
"4196",2019-11-27,"Washington Wizards",140,"Phoenix Suns",132,14123,0,-8,8,"2019-20",43.5897435897436
"4197",2019-11-27,"Los Angeles Lakers",114,"New Orleans Pelicans",110,18626,0,-4,4,"2019-20",41.6666666666667
"4198",2019-11-27,"Oklahoma City Thunder",119,"Portland Trail Blazers",136,19870,1,17,17,"2019-20",56.4102564102564
"4199",2019-11-27,"Chicago Bulls",90,"Golden State Warriors",104,18064,1,14,14,"2019-20",23.5294117647059
"4200",2019-11-29,"Boston Celtics",107,"Brooklyn Nets",112,17732,1,5,5,"2019-20",52.6315789473684
"4201",2019-11-29,"Charlotte Hornets",110,"Detroit Pistons",107,15006,0,-3,3,"2019-20",33.3333333333333
"4202",2019-11-29,"Toronto Raptors",90,"Orlando Magic",83,17014,0,-7,7,"2019-20",48.6486486486487
"4203",2019-11-29,"Milwaukee Bucks",119,"Cleveland Cavaliers",110,19432,0,-9,9,"2019-20",30.5555555555556
"4204",2019-11-29,"Philadelphia 76ers",101,"New York Knicks",95,18109,0,-6,6,"2019-20",33.3333333333333
"4205",2019-11-29,"Atlanta Hawks",104,"Indiana Pacers",105,15827,1,1,1,"2019-20",65.7894736842105
"4206",2019-11-29,"Utah Jazz",103,"Memphis Grizzlies",94,16605,0,-9,9,"2019-20",54.0540540540541
"4207",2019-11-29,"Golden State Warriors",105,"Miami Heat",122,19600,1,17,17,"2019-20",76.0869565217391
"4208",2019-11-29,"New Orleans Pelicans",104,"Oklahoma City Thunder",109,18203,1,5,5,"2019-20",65
"4209",2019-11-29,"Los Angeles Clippers",97,"San Antonio Spurs",107,18354,1,10,10,"2019-20",55.8823529411765
"4210",2019-11-29,"Dallas Mavericks",120,"Phoenix Suns",113,18055,0,-7,7,"2019-20",43.5897435897436
"4211",2019-11-29,"Chicago Bulls",103,"Portland Trail Blazers",107,20139,1,4,4,"2019-20",56.4102564102564
"4212",2019-11-29,"Washington Wizards",103,"Los Angeles Lakers",125,18997,1,22,22,"2019-20",72.3404255319149
"4213",2019-11-30,"Denver Nuggets",97,"Sacramento Kings",100,17583,1,3,3,"2019-20",45.7142857142857
"4214",2019-11-30,"Indiana Pacers",116,"Philadelphia 76ers",119,20517,1,3,3,"2019-20",83.7837837837838
"4215",2019-11-30,"Atlanta Hawks",111,"Houston Rockets",158,18055,1,47,47,"2019-20",66.6666666666667
"4216",2019-11-30,"Charlotte Hornets",96,"Milwaukee Bucks",137,17550,1,41,41,"2019-20",78.0487804878049
"4217",2019-12-01,"Miami Heat",109,"Brooklyn Nets",106,17026,0,-3,3,"2019-20",52.6315789473684
"4218",2019-12-01,"Memphis Grizzlies",115,"Minnesota Timberwolves",107,12276,0,-8,8,"2019-20",25
"4219",2019-12-01,"Boston Celtics",113,"New York Knicks",104,18005,0,-9,9,"2019-20",33.3333333333333
"4220",2019-12-01,"Dallas Mavericks",114,"Los Angeles Lakers",100,18997,0,-14,14,"2019-20",72.3404255319149
"4221",2019-12-01,"San Antonio Spurs",98,"Detroit Pistons",132,14270,1,34,34,"2019-20",33.3333333333333
"4222",2019-12-01,"Oklahoma City Thunder",107,"New Orleans Pelicans",104,15427,0,-3,3,"2019-20",41.6666666666667
"4223",2019-12-01,"Golden State Warriors",96,"Orlando Magic",100,15052,1,4,4,"2019-20",48.6486486486487
"4224",2019-12-01,"Utah Jazz",110,"Toronto Raptors",130,18132,1,20,20,"2019-20",66.6666666666667
"4225",2019-12-01,"Washington Wizards",125,"Los Angeles Clippers",150,19068,1,25,25,"2019-20",69.7674418604651
"4226",2019-12-02,"Phoenix Suns",109,"Charlotte Hornets",104,11221,0,-5,5,"2019-20",32.258064516129
"4227",2019-12-02,"Utah Jazz",94,"Philadelphia 76ers",103,20208,1,9,9,"2019-20",83.7837837837838
"4228",2019-12-02,"Golden State Warriors",79,"Atlanta Hawks",104,14278,1,25,25,"2019-20",41.1764705882353
"4229",2019-12-02,"Indiana Pacers",117,"Memphis Grizzlies",104,11919,0,-13,13,"2019-20",54.0540540540541
"4230",2019-12-02,"New York Knicks",88,"Milwaukee Bucks",132,17385,1,44,44,"2019-20",78.0487804878049
"4231",2019-12-02,"Chicago Bulls",113,"Sacramento Kings",106,17257,0,-7,7,"2019-20",45.7142857142857
"4232",2019-12-03,"Detroit Pistons",127,"Cleveland Cavaliers",94,17504,0,-33,33,"2019-20",30.5555555555556
"4233",2019-12-03,"Orlando Magic",127,"Washington Wizards",120,13159,0,-7,7,"2019-20",44.4444444444444
"4234",2019-12-03,"Dallas Mavericks",118,"New Orleans Pelicans",97,14664,0,-21,21,"2019-20",41.6666666666667
"4235",2019-12-03,"Miami Heat",121,"Toronto Raptors",110,19800,0,-11,11,"2019-20",66.6666666666667
"4236",2019-12-03,"Houston Rockets",133,"San Antonio Spurs",135,18354,1,2,2,"2019-20",55.8823529411765
"4237",2019-12-03,"Los Angeles Lakers",105,"Denver Nuggets",96,19658,0,-9,9,"2019-20",67.3913043478261
"4238",2019-12-03,"Portland Trail Blazers",97,"Los Angeles Clippers",117,19068,1,20,20,"2019-20",69.7674418604651
"4239",2019-12-04,"Golden State Warriors",91,"Charlotte Hornets",106,14355,1,15,15,"2019-20",32.258064516129
"4240",2019-12-04,"Milwaukee Bucks",127,"Detroit Pistons",103,15742,0,-24,24,"2019-20",33.3333333333333
"4241",2019-12-04,"Phoenix Suns",114,"Orlando Magic",128,15176,1,14,14,"2019-20",48.6486486486487
"4242",2019-12-04,"Brooklyn Nets",130,"Atlanta Hawks",118,15694,0,-12,12,"2019-20",41.1764705882353
"4243",2019-12-04,"Miami Heat",93,"Boston Celtics",112,19156,1,19,19,"2019-20",65.9090909090909
"4244",2019-12-04,"Memphis Grizzlies",99,"Chicago Bulls",106,15017,1,7,7,"2019-20",41.1764705882353
"4245",2019-12-04,"Indiana Pacers",107,"Oklahoma City Thunder",100,18203,0,-7,7,"2019-20",65
"4246",2019-12-04,"Minnesota Timberwolves",114,"Dallas Mavericks",121,19671,1,7,7,"2019-20",51.219512195122
"4247",2019-12-04,"Los Angeles Lakers",121,"Utah Jazz",96,18306,0,-25,25,"2019-20",65.7894736842105
"4248",2019-12-04,"Sacramento Kings",116,"Portland Trail Blazers",127,19393,1,11,11,"2019-20",56.4102564102564
"4249",2019-12-05,"Philadelphia 76ers",113,"Washington Wizards",119,16554,1,6,6,"2019-20",44.4444444444444
"4250",2019-12-05,"Denver Nuggets",129,"New York Knicks",92,18171,0,-37,37,"2019-20",33.3333333333333
"4251",2019-12-05,"Houston Rockets",119,"Toronto Raptors",109,19800,0,-10,10,"2019-20",66.6666666666667
"4252",2019-12-05,"Phoenix Suns",139,"New Orleans Pelicans",132,15607,0,-7,7,"2019-20",41.6666666666667
"4253",2019-12-06,"Brooklyn Nets",111,"Charlotte Hornets",104,15075,0,-7,7,"2019-20",32.258064516129
"4254",2019-12-06,"Orlando Magic",93,"Cleveland Cavaliers",87,18446,0,-6,6,"2019-20",30.5555555555556
"4255",2019-12-06,"Indiana Pacers",101,"Detroit Pistons",108,14894,1,7,7,"2019-20",33.3333333333333
"4256",2019-12-06,"Denver Nuggets",95,"Boston Celtics",108,19156,1,13,13,"2019-20",65.9090909090909
"4257",2019-12-06,"Golden State Warriors",100,"Chicago Bulls",98,18841,0,-2,2,"2019-20",41.1764705882353
"4258",2019-12-06,"Washington Wizards",103,"Miami Heat",112,19600,1,9,9,"2019-20",76.0869565217391
"4259",2019-12-06,"Minnesota Timberwolves",127,"Oklahoma City Thunder",139,18203,1,12,12,"2019-20",65
"4260",2019-12-06,"Los Angeles Clippers",91,"Milwaukee Bucks",119,17732,1,28,28,"2019-20",78.0487804878049
"4261",2019-12-06,"Sacramento Kings",104,"San Antonio Spurs",105,18354,1,1,1,"2019-20",55.8823529411765
"4262",2019-12-06,"Los Angeles Lakers",136,"Portland Trail Blazers",113,19912,0,-23,23,"2019-20",56.4102564102564
"4263",2019-12-07,"New Orleans Pelicans",84,"Dallas Mavericks",130,19456,1,46,46,"2019-20",51.219512195122
"4264",2019-12-07,"Indiana Pacers",104,"New York Knicks",103,19110,0,-1,1,"2019-20",33.3333333333333
"4265",2019-12-07,"Cleveland Cavaliers",94,"Philadelphia 76ers",141,20844,1,47,47,"2019-20",83.7837837837838
"4266",2019-12-07,"Phoenix Suns",109,"Houston Rockets",115,18055,1,6,6,"2019-20",66.6666666666667
"4267",2019-12-07,"Memphis Grizzlies",112,"Utah Jazz",126,18306,1,14,14,"2019-20",65.7894736842105
"4268",2019-12-08,"Denver Nuggets",102,"Brooklyn Nets",105,16679,1,3,3,"2019-20",52.6315789473684
"4269",2019-12-08,"Atlanta Hawks",122,"Charlotte Hornets",107,15489,0,-15,15,"2019-20",32.258064516129
"4270",2019-12-08,"Chicago Bulls",105,"Miami Heat",110,19600,1,5,5,"2019-20",76.0869565217391
"4271",2019-12-08,"Toronto Raptors",104,"Philadelphia 76ers",110,20313,1,6,6,"2019-20",83.7837837837838
"4272",2019-12-08,"Los Angeles Clippers",135,"Washington Wizards",119,15946,0,-16,16,"2019-20",44.4444444444444
"4273",2019-12-08,"Sacramento Kings",110,"Dallas Mavericks",106,19566,0,-4,4,"2019-20",51.219512195122
"4274",2019-12-08,"Oklahoma City Thunder",108,"Portland Trail Blazers",96,19393,0,-12,12,"2019-20",56.4102564102564
"4275",2019-12-08,"Minnesota Timberwolves",125,"Los Angeles Lakers",142,18997,1,17,17,"2019-20",72.3404255319149
"4276",2019-12-09,"Los Angeles Clippers",110,"Indiana Pacers",99,14644,0,-11,11,"2019-20",65.7894736842105
"4277",2019-12-09,"Cleveland Cavaliers",88,"Boston Celtics",110,19156,1,22,22,"2019-20",65.9090909090909
"4278",2019-12-09,"Toronto Raptors",93,"Chicago Bulls",92,14775,0,-1,1,"2019-20",41.1764705882353
"4279",2019-12-09,"Sacramento Kings",119,"Houston Rockets",118,18055,0,-1,1,"2019-20",66.6666666666667
"4280",2019-12-09,"Orlando Magic",101,"Milwaukee Bucks",110,17385,1,9,9,"2019-20",78.0487804878049
"4281",2019-12-09,"Detroit Pistons",105,"New Orleans Pelicans",103,13694,0,-2,2,"2019-20",41.6666666666667
"4282",2019-12-09,"Minnesota Timberwolves",109,"Phoenix Suns",125,13230,1,16,16,"2019-20",43.5897435897436
"4283",2019-12-09,"Oklahoma City Thunder",104,"Utah Jazz",90,18306,0,-14,14,"2019-20",65.7894736842105
"4284",2019-12-09,"Memphis Grizzlies",110,"Golden State Warriors",102,18064,0,-8,8,"2019-20",23.5294117647059
"4285",2019-12-10,"Washington Wizards",107,"Charlotte Hornets",114,10626,1,7,7,"2019-20",32.258064516129
"4286",2019-12-10,"Atlanta Hawks",121,"Miami Heat",135,19600,1,14,14,"2019-20",76.0869565217391
"4287",2019-12-10,"Denver Nuggets",92,"Philadelphia 76ers",97,20591,1,5,5,"2019-20",83.7837837837838
"4288",2019-12-10,"New York Knicks",87,"Portland Trail Blazers",115,19393,1,28,28,"2019-20",56.4102564102564
"4289",2019-12-11,"Houston Rockets",116,"Cleveland Cavaliers",110,17122,0,-6,6,"2019-20",30.5555555555556
"4290",2019-12-11,"Boston Celtics",117,"Indiana Pacers",122,15637,1,5,5,"2019-20",65.7894736842105
"4291",2019-12-11,"Los Angeles Lakers",96,"Orlando Magic",87,18846,0,-9,9,"2019-20",48.6486486486487
"4292",2019-12-11,"Los Angeles Clippers",112,"Toronto Raptors",92,20144,0,-20,20,"2019-20",66.6666666666667
"4293",2019-12-11,"Charlotte Hornets",113,"Brooklyn Nets",108,15631,0,-5,5,"2019-20",52.6315789473684
"4294",2019-12-11,"Atlanta Hawks",102,"Chicago Bulls",136,15084,1,34,34,"2019-20",41.1764705882353
"4295",2019-12-11,"Utah Jazz",127,"Minnesota Timberwolves",116,12369,0,-11,11,"2019-20",25
"4296",2019-12-11,"Memphis Grizzlies",115,"Phoenix Suns",108,12254,0,-7,7,"2019-20",43.5897435897436
"4297",2019-12-11,"New Orleans Pelicans",112,"Milwaukee Bucks",127,17385,1,15,15,"2019-20",78.0487804878049
"4298",2019-12-11,"Oklahoma City Thunder",93,"Sacramento Kings",94,16723,1,1,1,"2019-20",45.7142857142857
"4299",2019-12-11,"New York Knicks",124,"Golden State Warriors",122,18064,0,-2,2,"2019-20",23.5294117647059
"4300",2019-12-12,"Philadelphia 76ers",115,"Boston Celtics",109,19156,0,-6,6,"2019-20",65.9090909090909
"4301",2019-12-12,"Cleveland Cavaliers",117,"San Antonio Spurs",109,18354,0,-8,8,"2019-20",55.8823529411765
"4302",2019-12-12,"Dallas Mavericks",122,"Detroit Pistons",111,20064,0,-11,11,"2019-20",33.3333333333333
"4303",2019-12-12,"Portland Trail Blazers",99,"Denver Nuggets",114,18828,1,15,15,"2019-20",67.3913043478261
"4304",2019-12-13,"Los Angeles Lakers",113,"Miami Heat",110,20013,0,-3,3,"2019-20",76.0869565217391
"4305",2019-12-13,"Houston Rockets",130,"Orlando Magic",107,16335,0,-23,23,"2019-20",48.6486486486487
"4306",2019-12-13,"New Orleans Pelicans",109,"Philadelphia 76ers",116,20620,1,7,7,"2019-20",83.7837837837838
"4307",2019-12-13,"Indiana Pacers",110,"Atlanta Hawks",100,15121,0,-10,10,"2019-20",41.1764705882353
"4308",2019-12-13,"Charlotte Hornets",83,"Chicago Bulls",73,18377,0,-10,10,"2019-20",41.1764705882353
"4309",2019-12-13,"Milwaukee Bucks",127,"Memphis Grizzlies",114,16109,0,-13,13,"2019-20",54.0540540540541
"4310",2019-12-13,"Golden State Warriors",106,"Utah Jazz",114,18306,1,8,8,"2019-20",65.7894736842105
"4311",2019-12-13,"Los Angeles Clippers",124,"Minnesota Timberwolves",117,17585,0,-7,7,"2019-20",25
"4312",2019-12-13,"New York Knicks",103,"Sacramento Kings",101,17583,0,-2,2,"2019-20",45.7142857142857
"4313",2019-12-14,"San Antonio Spurs",121,"Phoenix Suns",119,20013,0,-2,2,"2019-20",43.5897435897436
"4314",2019-12-14,"Brooklyn Nets",102,"Toronto Raptors",110,19800,1,8,8,"2019-20",66.6666666666667
"4315",2019-12-14,"Los Angeles Clippers",106,"Chicago Bulls",109,18426,1,3,3,"2019-20",41.1764705882353
"4316",2019-12-14,"Washington Wizards",111,"Memphis Grizzlies",128,15631,1,17,17,"2019-20",54.0540540540541
"4317",2019-12-14,"Miami Heat",122,"Dallas Mavericks",118,20333,0,-4,4,"2019-20",51.219512195122
"4318",2019-12-14,"Cleveland Cavaliers",108,"Milwaukee Bucks",125,17481,1,17,17,"2019-20",78.0487804878049
"4319",2019-12-14,"Oklahoma City Thunder",102,"Denver Nuggets",110,19520,1,8,8,"2019-20",67.3913043478261
"4320",2019-12-14,"Detroit Pistons",115,"Houston Rockets",107,18055,0,-8,8,"2019-20",66.6666666666667
"4321",2019-12-15,"Orlando Magic",130,"New Orleans Pelicans",119,15388,0,-11,11,"2019-20",41.6666666666667
"4322",2019-12-15,"Charlotte Hornets",85,"Indiana Pacers",107,16061,1,22,22,"2019-20",65.7894736842105
"4323",2019-12-15,"Los Angeles Lakers",101,"Atlanta Hawks",96,16962,0,-5,5,"2019-20",41.1764705882353
"4324",2019-12-15,"Philadelphia 76ers",89,"Brooklyn Nets",109,17732,1,20,20,"2019-20",52.6315789473684
"4325",2019-12-15,"New York Knicks",105,"Denver Nuggets",111,18867,1,6,6,"2019-20",67.3913043478261
"4326",2019-12-15,"Sacramento Kings",100,"Golden State Warriors",79,18064,0,-21,21,"2019-20",23.5294117647059
"4327",2019-12-16,"Washington Wizards",133,"Detroit Pistons",119,14632,0,-14,14,"2019-20",33.3333333333333
"4328",2019-12-16,"Cleveland Cavaliers",113,"Toronto Raptors",133,19800,1,20,20,"2019-20",66.6666666666667
"4329",2019-12-16,"San Antonio Spurs",107,"Houston Rockets",109,18055,1,2,2,"2019-20",66.6666666666667
"4330",2019-12-16,"Miami Heat",111,"Memphis Grizzlies",118,14021,1,7,7,"2019-20",54.0540540540541
"4331",2019-12-16,"Dallas Mavericks",120,"Milwaukee Bucks",116,17727,0,-4,4,"2019-20",78.0487804878049
"4332",2019-12-16,"Chicago Bulls",106,"Oklahoma City Thunder",109,18203,1,3,3,"2019-20",65
"4333",2019-12-16,"Portland Trail Blazers",111,"Phoenix Suns",110,14193,0,-1,1,"2019-20",43.5897435897436
"4334",2019-12-17,"Sacramento Kings",102,"Charlotte Hornets",110,13229,1,8,8,"2019-20",32.258064516129
"4335",2019-12-17,"Los Angeles Lakers",102,"Indiana Pacers",105,17923,1,3,3,"2019-20",65.7894736842105
"4336",2019-12-17,"Atlanta Hawks",120,"New York Knicks",143,18268,1,23,23,"2019-20",33.3333333333333
"4337",2019-12-17,"Brooklyn Nets",108,"New Orleans Pelicans",101,15177,0,-7,7,"2019-20",41.6666666666667
"4338",2019-12-17,"Orlando Magic",102,"Utah Jazz",109,18306,1,7,7,"2019-20",65.7894736842105
"4339",2019-12-17,"Phoenix Suns",99,"Los Angeles Clippers",120,19068,1,21,21,"2019-20",69.7674418604651
"4340",2019-12-18,"Charlotte Hornets",98,"Cleveland Cavaliers",100,17023,1,2,2,"2019-20",30.5555555555556
"4341",2019-12-18,"Toronto Raptors",112,"Detroit Pistons",99,15319,0,-13,13,"2019-20",33.3333333333333
"4342",2019-12-18,"Miami Heat",108,"Philadelphia 76ers",104,20715,0,-4,4,"2019-20",83.7837837837838
"4343",2019-12-18,"Chicago Bulls",110,"Washington Wizards",109,14987,0,-1,1,"2019-20",44.4444444444444
"4344",2019-12-18,"New Orleans Pelicans",107,"Minnesota Timberwolves",99,12490,0,-8,8,"2019-20",25
"4345",2019-12-18,"Memphis Grizzlies",122,"Oklahoma City Thunder",126,18203,1,4,4,"2019-20",65
"4346",2019-12-18,"Orlando Magic",104,"Denver Nuggets",113,18182,1,9,9,"2019-20",67.3913043478261
"4347",2019-12-18,"Boston Celtics",109,"Dallas Mavericks",103,20181,0,-6,6,"2019-20",51.219512195122
"4348",2019-12-18,"Golden State Warriors",112,"Portland Trail Blazers",122,19393,1,10,10,"2019-20",56.4102564102564
"4349",2019-12-19,"Utah Jazz",111,"Atlanta Hawks",106,16739,0,-5,5,"2019-20",41.1764705882353
"4350",2019-12-19,"Los Angeles Lakers",104,"Milwaukee Bucks",111,18051,1,7,7,"2019-20",78.0487804878049
"4351",2019-12-19,"Brooklyn Nets",105,"San Antonio Spurs",118,18354,1,13,13,"2019-20",55.8823529411765
"4352",2019-12-19,"Houston Rockets",122,"Los Angeles Clippers",117,19068,0,-5,5,"2019-20",69.7674418604651
"4353",2019-12-20,"Memphis Grizzlies",107,"Cleveland Cavaliers",114,19432,1,7,7,"2019-20",30.5555555555556
"4354",2019-12-20,"Sacramento Kings",105,"Indiana Pacers",119,14649,1,14,14,"2019-20",65.7894736842105
"4355",2019-12-20,"Detroit Pistons",93,"Boston Celtics",114,19156,1,21,21,"2019-20",65.9090909090909
"4356",2019-12-20,"Washington Wizards",118,"Toronto Raptors",122,19800,1,4,4,"2019-20",66.6666666666667
"4357",2019-12-20,"New York Knicks",114,"Miami Heat",129,19704,1,15,15,"2019-20",76.0869565217391
"4358",2019-12-20,"Phoenix Suns",108,"Oklahoma City Thunder",126,18203,1,18,18,"2019-20",65
"4359",2019-12-20,"Dallas Mavericks",117,"Philadelphia 76ers",98,20778,0,-19,19,"2019-20",83.7837837837838
"4360",2019-12-20,"Minnesota Timberwolves",100,"Denver Nuggets",109,19520,1,9,9,"2019-20",67.3913043478261
"4361",2019-12-20,"Orlando Magic",103,"Portland Trail Blazers",118,19393,1,15,15,"2019-20",56.4102564102564
"4362",2019-12-20,"New Orleans Pelicans",102,"Golden State Warriors",106,18064,1,4,4,"2019-20",23.5294117647059
"4363",2019-12-21,"Utah Jazz",114,"Charlotte Hornets",107,16187,0,-7,7,"2019-20",32.258064516129
"4364",2019-12-21,"Atlanta Hawks",112,"Brooklyn Nets",122,16496,1,10,10,"2019-20",52.6315789473684
"4365",2019-12-21,"Chicago Bulls",119,"Detroit Pistons",107,15948,0,-12,12,"2019-20",33.3333333333333
"4366",2019-12-21,"Washington Wizards",108,"Philadelphia 76ers",125,20529,1,17,17,"2019-20",83.7837837837838
"4367",2019-12-21,"Milwaukee Bucks",123,"New York Knicks",102,18124,0,-21,21,"2019-20",33.3333333333333
"4368",2019-12-21,"Sacramento Kings",115,"Memphis Grizzlies",119,15603,1,4,4,"2019-20",54.0540540540541
"4369",2019-12-21,"Los Angeles Clippers",134,"San Antonio Spurs",109,18354,0,-25,25,"2019-20",55.8823529411765
"4370",2019-12-21,"Houston Rockets",139,"Phoenix Suns",125,16061,0,-14,14,"2019-20",43.5897435897436
"4371",2019-12-21,"Minnesota Timberwolves",106,"Portland Trail Blazers",113,19393,1,7,7,"2019-20",56.4102564102564
"4372",2019-12-22,"Dallas Mavericks",107,"Toronto Raptors",110,19800,1,3,3,"2019-20",66.6666666666667
"4373",2019-12-22,"Charlotte Hornets",93,"Boston Celtics",119,19156,1,26,26,"2019-20",65.9090909090909
"4374",2019-12-22,"Indiana Pacers",89,"Milwaukee Bucks",117,18029,1,28,28,"2019-20",78.0487804878049
"4375",2019-12-22,"Los Angeles Clippers",112,"Oklahoma City Thunder",118,18203,1,6,6,"2019-20",65
"4376",2019-12-22,"Denver Nuggets",128,"Los Angeles Lakers",104,18997,0,-24,24,"2019-20",72.3404255319149
"4377",2019-12-23,"Atlanta Hawks",118,"Cleveland Cavaliers",121,18007,1,3,3,"2019-20",30.5555555555556
"4378",2019-12-23,"Philadelphia 76ers",125,"Detroit Pistons",109,16476,0,-16,16,"2019-20",33.3333333333333
"4379",2019-12-23,"Toronto Raptors",115,"Indiana Pacers",120,17164,1,5,5,"2019-20",65.7894736842105
"4380",2019-12-23,"Washington Wizards",121,"New York Knicks",115,19413,0,-6,6,"2019-20",33.3333333333333
"4381",2019-12-23,"Chicago Bulls",95,"Orlando Magic",103,18846,1,8,8,"2019-20",48.6486486486487
"4382",2019-12-23,"Utah Jazz",104,"Miami Heat",107,19890,1,3,3,"2019-20",76.0869565217391
"4383",2019-12-23,"San Antonio Spurs",145,"Memphis Grizzlies",115,16776,0,-30,30,"2019-20",54.0540540540541
"4384",2019-12-23,"Denver Nuggets",113,"Phoenix Suns",111,16041,0,-2,2,"2019-20",43.5897435897436
"4385",2019-12-23,"New Orleans Pelicans",102,"Portland Trail Blazers",94,19499,0,-8,8,"2019-20",56.4102564102564
"4386",2019-12-23,"Houston Rockets",113,"Sacramento Kings",104,17583,0,-9,9,"2019-20",45.7142857142857
"4387",2019-12-23,"Minnesota Timberwolves",104,"Golden State Warriors",113,18064,1,9,9,"2019-20",23.5294117647059
"4388",2019-12-25,"Boston Celtics",118,"Toronto Raptors",102,19800,0,-16,16,"2019-20",66.6666666666667
"4389",2019-12-25,"Milwaukee Bucks",109,"Philadelphia 76ers",121,21028,1,12,12,"2019-20",83.7837837837838
"4390",2019-12-25,"Houston Rockets",104,"Golden State Warriors",116,18064,1,12,12,"2019-20",23.5294117647059
"4391",2019-12-25,"Los Angeles Clippers",111,"Los Angeles Lakers",106,18997,0,-5,5,"2019-20",72.3404255319149
"4392",2019-12-25,"New Orleans Pelicans",112,"Denver Nuggets",100,19520,0,-12,12,"2019-20",67.3913043478261
"4393",2019-12-26,"Washington Wizards",102,"Detroit Pistons",132,17188,1,30,30,"2019-20",33.3333333333333
"4394",2019-12-26,"New York Knicks",94,"Brooklyn Nets",82,17732,0,-12,12,"2019-20",52.6315789473684
"4395",2019-12-26,"San Antonio Spurs",98,"Dallas Mavericks",102,20427,1,4,4,"2019-20",51.219512195122
"4396",2019-12-26,"Memphis Grizzlies",110,"Oklahoma City Thunder",97,18203,0,-13,13,"2019-20",65
"4397",2019-12-26,"Minnesota Timberwolves",105,"Sacramento Kings",104,17583,0,-1,1,"2019-20",45.7142857142857
"4398",2019-12-26,"Portland Trail Blazers",115,"Utah Jazz",121,18306,1,6,6,"2019-20",65.7894736842105
"4399",2019-12-27,"Cleveland Cavaliers",117,"Boston Celtics",129,19156,1,12,12,"2019-20",65.9090909090909
"4400",2019-12-27,"Oklahoma City Thunder",104,"Charlotte Hornets",102,18418,0,-2,2,"2019-20",32.258064516129
"4401",2019-12-27,"Philadelphia 76ers",97,"Orlando Magic",98,17311,1,1,1,"2019-20",48.6486486486487
"4402",2019-12-27,"Milwaukee Bucks",112,"Atlanta Hawks",86,17358,0,-26,26,"2019-20",41.1764705882353
"4403",2019-12-27,"Indiana Pacers",112,"Miami Heat",113,19767,1,1,1,"2019-20",76.0869565217391
"4404",2019-12-27,"Phoenix Suns",96,"Golden State Warriors",105,18064,1,9,9,"2019-20",23.5294117647059
"4405",2019-12-28,"Memphis Grizzlies",110,"Denver Nuggets",119,19697,1,9,9,"2019-20",67.3913043478261
"4406",2019-12-28,"Toronto Raptors",113,"Boston Celtics",97,19156,0,-16,16,"2019-20",65.9090909090909
"4407",2019-12-28,"Indiana Pacers",98,"New Orleans Pelicans",120,15391,1,22,22,"2019-20",41.6666666666667
"4408",2019-12-28,"Atlanta Hawks",81,"Chicago Bulls",116,21496,1,35,35,"2019-20",41.1764705882353
"4409",2019-12-28,"Brooklyn Nets",98,"Houston Rockets",108,18306,1,10,10,"2019-20",66.6666666666667
"4410",2019-12-28,"Philadelphia 76ers",116,"Miami Heat",117,19865,1,1,1,"2019-20",76.0869565217391
"4411",2019-12-28,"Cleveland Cavaliers",94,"Minnesota Timberwolves",88,15411,0,-6,6,"2019-20",25
"4412",2019-12-28,"New York Knicks",107,"Washington Wizards",100,19033,0,-7,7,"2019-20",44.4444444444444
"4413",2019-12-28,"Dallas Mavericks",141,"Golden State Warriors",121,18064,0,-20,20,"2019-20",23.5294117647059
"4414",2019-12-28,"Orlando Magic",100,"Milwaukee Bucks",111,17920,1,11,11,"2019-20",78.0487804878049
"4415",2019-12-28,"Detroit Pistons",109,"San Antonio Spurs",136,18524,1,27,27,"2019-20",55.8823529411765
"4416",2019-12-28,"Phoenix Suns",112,"Sacramento Kings",110,17583,0,-2,2,"2019-20",45.7142857142857
"4417",2019-12-28,"Los Angeles Lakers",128,"Portland Trail Blazers",120,19960,0,-8,8,"2019-20",56.4102564102564
"4418",2019-12-28,"Utah Jazz",120,"Los Angeles Clippers",107,19068,0,-13,13,"2019-20",69.7674418604651
"4419",2019-12-29,"Oklahoma City Thunder",98,"Toronto Raptors",97,19800,0,-1,1,"2019-20",66.6666666666667
"4420",2019-12-29,"Sacramento Kings",115,"Denver Nuggets",120,19520,1,5,5,"2019-20",67.3913043478261
"4421",2019-12-29,"Charlotte Hornets",104,"Memphis Grizzlies",117,16842,1,13,13,"2019-20",54.0540540540541
"4422",2019-12-29,"Houston Rockets",112,"New Orleans Pelicans",127,17712,1,15,15,"2019-20",41.6666666666667
"4423",2019-12-29,"Dallas Mavericks",95,"Los Angeles Lakers",108,18997,1,13,13,"2019-20",72.3404255319149
"4424",2019-12-30,"Atlanta Hawks",101,"Orlando Magic",93,17784,0,-8,8,"2019-20",48.6486486486487
"4425",2019-12-30,"Miami Heat",105,"Washington Wizards",123,20476,1,18,18,"2019-20",44.4444444444444
"4426",2019-12-30,"Milwaukee Bucks",123,"Chicago Bulls",102,21954,0,-21,21,"2019-20",41.1764705882353
"4427",2019-12-30,"Brooklyn Nets",115,"Minnesota Timberwolves",122,15824,1,7,7,"2019-20",25
"4428",2019-12-30,"Detroit Pistons",81,"Utah Jazz",104,18306,1,23,23,"2019-20",65.7894736842105
"4429",2019-12-30,"Phoenix Suns",122,"Portland Trail Blazers",116,19896,0,-6,6,"2019-20",56.4102564102564
"4430",2019-12-31,"Boston Celtics",109,"Charlotte Hornets",92,19216,0,-17,17,"2019-20",32.258064516129
"4431",2019-12-31,"Philadelphia 76ers",97,"Indiana Pacers",115,17923,1,18,18,"2019-20",65.7894736842105
"4432",2019-12-31,"Los Angeles Clippers",105,"Sacramento Kings",87,16231,0,-18,18,"2019-20",45.7142857142857
"4433",2019-12-31,"Denver Nuggets",104,"Houston Rockets",130,18055,1,26,26,"2019-20",66.6666666666667
"4434",2019-12-31,"Golden State Warriors",113,"San Antonio Spurs",117,18354,1,4,4,"2019-20",55.8823529411765
"4435",2019-12-31,"Cleveland Cavaliers",97,"Toronto Raptors",117,19800,1,20,20,"2019-20",66.6666666666667
"4436",2019-12-31,"Dallas Mavericks",101,"Oklahoma City Thunder",106,18203,1,5,5,"2019-20",65
"4437",2020-01-01,"Orlando Magic",122,"Washington Wizards",101,14921,0,-21,21,"2019-20",44.4444444444444
"4438",2020-01-01,"Portland Trail Blazers",93,"New York Knicks",117,19812,1,24,24,"2019-20",33.3333333333333
"4439",2020-01-01,"Minnesota Timberwolves",104,"Milwaukee Bucks",106,17819,1,2,2,"2019-20",78.0487804878049
"4440",2020-01-01,"Phoenix Suns",107,"Los Angeles Lakers",117,18997,1,10,10,"2019-20",72.3404255319149
"4441",2020-01-02,"Charlotte Hornets",109,"Cleveland Cavaliers",106,17859,0,-3,3,"2019-20",30.5555555555556
"4442",2020-01-02,"Denver Nuggets",124,"Indiana Pacers",116,16688,0,-8,8,"2019-20",65.7894736842105
"4443",2020-01-02,"Toronto Raptors",76,"Miami Heat",84,19939,1,8,8,"2019-20",76.0869565217391
"4444",2020-01-02,"Utah Jazz",102,"Chicago Bulls",98,19398,0,-4,4,"2019-20",41.1764705882353
"4445",2020-01-02,"Golden State Warriors",84,"Minnesota Timberwolves",99,15477,1,15,15,"2019-20",25
"4446",2020-01-02,"Brooklyn Nets",111,"Dallas Mavericks",123,20289,1,12,12,"2019-20",51.219512195122
"4447",2020-01-02,"Oklahoma City Thunder",109,"San Antonio Spurs",103,18354,0,-6,6,"2019-20",55.8823529411765
"4448",2020-01-02,"Memphis Grizzlies",123,"Sacramento Kings",128,17351,1,5,5,"2019-20",45.7142857142857
"4449",2020-01-02,"Detroit Pistons",112,"Los Angeles Clippers",126,19068,1,14,14,"2019-20",69.7674418604651
"4450",2020-01-03,"Atlanta Hawks",106,"Boston Celtics",109,19156,1,3,3,"2019-20",65.9090909090909
"4451",2020-01-03,"Miami Heat",85,"Orlando Magic",105,17198,1,20,20,"2019-20",48.6486486486487
"4452",2020-01-03,"Portland Trail Blazers",122,"Washington Wizards",103,17945,0,-19,19,"2019-20",44.4444444444444
"4453",2020-01-03,"Philadelphia 76ers",108,"Houston Rockets",118,18055,1,10,10,"2019-20",66.6666666666667
"4454",2020-01-03,"New York Knicks",112,"Phoenix Suns",120,18055,1,8,8,"2019-20",43.5897435897436
"4455",2020-01-03,"New Orleans Pelicans",113,"Los Angeles Lakers",123,18997,1,10,10,"2019-20",72.3404255319149
"4456",2020-01-04,"Memphis Grizzlies",140,"Los Angeles Clippers",114,19068,0,-26,26,"2019-20",69.7674418604651
"4457",2020-01-04,"Toronto Raptors",121,"Brooklyn Nets",102,17732,0,-19,19,"2019-20",52.6315789473684
"4458",2020-01-04,"Utah Jazz",109,"Orlando Magic",96,16913,0,-13,13,"2019-20",48.6486486486487
"4459",2020-01-04,"Indiana Pacers",111,"Atlanta Hawks",116,16420,1,5,5,"2019-20",41.1764705882353
"4460",2020-01-04,"Oklahoma City Thunder",121,"Cleveland Cavaliers",106,19432,0,-15,15,"2019-20",30.5555555555556
"4461",2020-01-04,"Boston Celtics",111,"Chicago Bulls",104,21130,0,-7,7,"2019-20",41.1764705882353
"4462",2020-01-04,"Denver Nuggets",114,"Washington Wizards",128,16233,1,14,14,"2019-20",44.4444444444444
"4463",2020-01-04,"Charlotte Hornets",123,"Dallas Mavericks",120,20327,0,-3,3,"2019-20",51.219512195122
"4464",2020-01-04,"Detroit Pistons",111,"Golden State Warriors",104,18064,0,-7,7,"2019-20",23.5294117647059
"4465",2020-01-04,"San Antonio Spurs",118,"Milwaukee Bucks",127,18002,1,9,9,"2019-20",78.0487804878049
"4466",2020-01-04,"New Orleans Pelicans",117,"Sacramento Kings",115,16808,0,-2,2,"2019-20",45.7142857142857
"4467",2020-01-05,"New York Knicks",132,"Los Angeles Clippers",135,19068,1,3,3,"2019-20",69.7674418604651
"4468",2020-01-05,"Portland Trail Blazers",111,"Miami Heat",122,19846,1,11,11,"2019-20",76.0869565217391
"4469",2020-01-05,"Minnesota Timberwolves",118,"Cleveland Cavaliers",103,16159,0,-15,15,"2019-20",30.5555555555556
"4470",2020-01-05,"Memphis Grizzlies",121,"Phoenix Suns",114,14181,0,-7,7,"2019-20",43.5897435897436
"4471",2020-01-05,"Detroit Pistons",99,"Los Angeles Lakers",106,18997,1,7,7,"2019-20",72.3404255319149
"4472",2020-01-06,"Indiana Pacers",115,"Charlotte Hornets",104,13009,0,-11,11,"2019-20",32.258064516129
"4473",2020-01-06,"Brooklyn Nets",89,"Orlando Magic",101,15008,1,12,12,"2019-20",48.6486486486487
"4474",2020-01-06,"Oklahoma City Thunder",113,"Philadelphia 76ers",120,20561,1,7,7,"2019-20",83.7837837837838
"4475",2020-01-06,"Boston Celtics",94,"Washington Wizards",99,17963,1,5,5,"2019-20",44.4444444444444
"4476",2020-01-06,"Denver Nuggets",123,"Atlanta Hawks",115,15286,0,-8,8,"2019-20",41.1764705882353
"4477",2020-01-06,"Utah Jazz",128,"New Orleans Pelicans",126,14138,0,-2,2,"2019-20",41.6666666666667
"4478",2020-01-06,"Chicago Bulls",110,"Dallas Mavericks",118,20238,1,8,8,"2019-20",51.219512195122
"4479",2020-01-06,"Milwaukee Bucks",104,"San Antonio Spurs",126,18354,1,22,22,"2019-20",55.8823529411765
"4480",2020-01-06,"Golden State Warriors",98,"Sacramento Kings",111,15819,1,13,13,"2019-20",45.7142857142857
"4481",2020-01-07,"Detroit Pistons",115,"Cleveland Cavaliers",113,17274,0,-2,2,"2019-20",30.5555555555556
"4482",2020-01-07,"Portland Trail Blazers",101,"Toronto Raptors",99,19800,0,-2,2,"2019-20",66.6666666666667
"4483",2020-01-07,"Oklahoma City Thunder",111,"Brooklyn Nets",103,15677,0,-8,8,"2019-20",52.6315789473684
"4484",2020-01-07,"Minnesota Timberwolves",112,"Memphis Grizzlies",119,14117,1,7,7,"2019-20",54.0540540540541
"4485",2020-01-07,"Sacramento Kings",114,"Phoenix Suns",103,14134,0,-11,11,"2019-20",43.5897435897436
"4486",2020-01-07,"New York Knicks",87,"Los Angeles Lakers",117,18997,1,30,30,"2019-20",72.3404255319149
"4487",2020-01-08,"San Antonio Spurs",129,"Boston Celtics",114,19156,0,-15,15,"2019-20",65.9090909090909
"4488",2020-01-08,"Toronto Raptors",112,"Charlotte Hornets",110,13965,0,-2,2,"2019-20",32.258064516129
"4489",2020-01-08,"Miami Heat",122,"Indiana Pacers",108,17040,0,-14,14,"2019-20",65.7894736842105
"4490",2020-01-08,"Washington Wizards",89,"Orlando Magic",123,16013,1,34,34,"2019-20",48.6486486486487
"4491",2020-01-08,"Houston Rockets",122,"Atlanta Hawks",115,16514,0,-7,7,"2019-20",41.1764705882353
"4492",2020-01-08,"Denver Nuggets",107,"Dallas Mavericks",106,20314,0,-1,1,"2019-20",51.219512195122
"4493",2020-01-08,"Chicago Bulls",108,"New Orleans Pelicans",123,15324,1,15,15,"2019-20",41.6666666666667
"4494",2020-01-08,"New York Knicks",104,"Utah Jazz",128,18306,1,24,24,"2019-20",65.7894736842105
"4495",2020-01-08,"Milwaukee Bucks",107,"Golden State Warriors",98,18064,0,-9,9,"2019-20",23.5294117647059
"4496",2020-01-09,"Cleveland Cavaliers",115,"Detroit Pistons",112,13445,0,-3,3,"2019-20",33.3333333333333
"4497",2020-01-09,"Boston Celtics",98,"Philadelphia 76ers",109,20822,1,11,11,"2019-20",83.7837837837838
"4498",2020-01-09,"Portland Trail Blazers",102,"Minnesota Timberwolves",116,13720,1,14,14,"2019-20",25
"4499",2020-01-09,"Houston Rockets",92,"Oklahoma City Thunder",113,18203,1,21,21,"2019-20",65
"4500",2020-01-10,"Atlanta Hawks",101,"Washington Wizards",111,16360,1,10,10,"2019-20",44.4444444444444
"4501",2020-01-10,"New Orleans Pelicans",123,"New York Knicks",111,18003,0,-12,12,"2019-20",33.3333333333333
"4502",2020-01-10,"Miami Heat",113,"Brooklyn Nets",117,16011,1,4,4,"2019-20",52.6315789473684
"4503",2020-01-10,"Indiana Pacers",116,"Chicago Bulls",105,20229,0,-11,11,"2019-20",41.1764705882353
"4504",2020-01-10,"San Antonio Spurs",121,"Memphis Grizzlies",134,16448,1,13,13,"2019-20",54.0540540540541
"4505",2020-01-10,"Orlando Magic",94,"Phoenix Suns",98,14562,1,4,4,"2019-20",43.5897435897436
"4506",2020-01-10,"Charlotte Hornets",92,"Utah Jazz",109,18306,1,17,17,"2019-20",65.7894736842105
"4507",2020-01-10,"Los Angeles Lakers",129,"Dallas Mavericks",114,20542,0,-15,15,"2019-20",51.219512195122
"4508",2020-01-10,"Milwaukee Bucks",127,"Sacramento Kings",106,17583,0,-21,21,"2019-20",45.7142857142857
"4509",2020-01-10,"Golden State Warriors",100,"Los Angeles Clippers",109,19068,1,9,9,"2019-20",69.7674418604651
"4510",2020-01-11,"Minnesota Timberwolves",109,"Houston Rockets",139,18055,1,30,30,"2019-20",66.6666666666667
"4511",2020-01-11,"New Orleans Pelicans",105,"Boston Celtics",140,19156,1,35,35,"2019-20",65.9090909090909
"4512",2020-01-11,"Chicago Bulls",108,"Detroit Pistons",99,15951,0,-9,9,"2019-20",33.3333333333333
"4513",2020-01-11,"Los Angeles Lakers",125,"Oklahoma City Thunder",110,18203,0,-15,15,"2019-20",65
"4514",2020-01-11,"Philadelphia 76ers",91,"Dallas Mavericks",109,20244,1,18,18,"2019-20",51.219512195122
"4515",2020-01-11,"Cleveland Cavaliers",111,"Denver Nuggets",103,19533,0,-8,8,"2019-20",67.3913043478261
"4516",2020-01-11,"Milwaukee Bucks",122,"Portland Trail Blazers",101,19843,0,-21,21,"2019-20",56.4102564102564
"4517",2020-01-12,"Miami Heat",121,"New York Knicks",124,18861,1,3,3,"2019-20",33.3333333333333
"4518",2020-01-12,"Utah Jazz",127,"Washington Wizards",116,15953,0,-11,11,"2019-20",44.4444444444444
"4519",2020-01-12,"Atlanta Hawks",86,"Brooklyn Nets",108,15201,1,22,22,"2019-20",52.6315789473684
"4520",2020-01-12,"Golden State Warriors",102,"Memphis Grizzlies",122,16408,1,20,20,"2019-20",54.0540540540541
"4521",2020-01-12,"San Antonio Spurs",105,"Toronto Raptors",104,19800,0,-1,1,"2019-20",66.6666666666667
"4522",2020-01-12,"Los Angeles Clippers",104,"Denver Nuggets",114,19520,1,10,10,"2019-20",67.3913043478261
"4523",2020-01-12,"Charlotte Hornets",92,"Phoenix Suns",100,14751,1,8,8,"2019-20",43.5897435897436
"4524",2020-01-13,"New Orleans Pelicans",117,"Detroit Pistons",110,13780,0,-7,7,"2019-20",33.3333333333333
"4525",2020-01-13,"Philadelphia 76ers",95,"Indiana Pacers",101,15257,1,6,6,"2019-20",65.7894736842105
"4526",2020-01-13,"Chicago Bulls",101,"Boston Celtics",113,19156,1,12,12,"2019-20",65.9090909090909
"4527",2020-01-13,"Oklahoma City Thunder",117,"Minnesota Timberwolves",104,11044,0,-13,13,"2019-20",25
"4528",2020-01-13,"Charlotte Hornets",112,"Portland Trail Blazers",115,19111,1,3,3,"2019-20",56.4102564102564
"4529",2020-01-13,"Orlando Magic",114,"Sacramento Kings",112,16299,0,-2,2,"2019-20",45.7142857142857
"4530",2020-01-13,"Cleveland Cavaliers",99,"Los Angeles Lakers",128,18997,1,29,29,"2019-20",72.3404255319149
"4531",2020-01-14,"Phoenix Suns",110,"Atlanta Hawks",123,16060,1,13,13,"2019-20",41.1764705882353
"4532",2020-01-14,"Utah Jazz",118,"Brooklyn Nets",107,15381,0,-11,11,"2019-20",52.6315789473684
"4533",2020-01-14,"Houston Rockets",110,"Memphis Grizzlies",121,16181,1,11,11,"2019-20",54.0540540540541
"4534",2020-01-14,"New York Knicks",102,"Milwaukee Bucks",128,17590,1,26,26,"2019-20",78.0487804878049
"4535",2020-01-14,"Dallas Mavericks",124,"Golden State Warriors",97,18064,0,-27,27,"2019-20",23.5294117647059
"4536",2020-01-14,"Cleveland Cavaliers",103,"Los Angeles Clippers",128,19068,1,25,25,"2019-20",69.7674418604651
"4537",2020-01-15,"Detroit Pistons",116,"Boston Celtics",103,19156,0,-13,13,"2019-20",65.9090909090909
"4538",2020-01-15,"Brooklyn Nets",106,"Philadelphia 76ers",117,20416,1,11,11,"2019-20",83.7837837837838
"4539",2020-01-15,"San Antonio Spurs",100,"Miami Heat",106,19704,1,6,6,"2019-20",76.0869565217391
"4540",2020-01-15,"Washington Wizards",106,"Chicago Bulls",115,19382,1,9,9,"2019-20",41.1764705882353
"4541",2020-01-15,"Indiana Pacers",104,"Minnesota Timberwolves",99,12648,0,-5,5,"2019-20",25
"4542",2020-01-15,"Toronto Raptors",130,"Oklahoma City Thunder",121,18203,0,-9,9,"2019-20",65
"4543",2020-01-15,"Charlotte Hornets",86,"Denver Nuggets",100,19520,1,14,14,"2019-20",67.3913043478261
"4544",2020-01-15,"Portland Trail Blazers",117,"Houston Rockets",107,18055,0,-10,10,"2019-20",66.6666666666667
"4545",2020-01-15,"Dallas Mavericks",127,"Sacramento Kings",123,17029,0,-4,4,"2019-20",45.7142857142857
"4546",2020-01-15,"Orlando Magic",119,"Los Angeles Lakers",118,18997,0,-1,1,"2019-20",72.3404255319149
"4547",2020-01-16,"Phoenix Suns",121,"New York Knicks",98,18215,0,-23,23,"2019-20",33.3333333333333
"4548",2020-01-16,"Boston Celtics",123,"Milwaukee Bucks",128,17873,1,5,5,"2019-20",78.0487804878049
"4549",2020-01-16,"Utah Jazz",132,"New Orleans Pelicans",138,16717,1,6,6,"2019-20",41.6666666666667
"4550",2020-01-16,"Denver Nuggets",134,"Golden State Warriors",131,18064,0,-3,3,"2019-20",23.5294117647059
"4551",2020-01-16,"Orlando Magic",95,"Los Angeles Clippers",122,19068,1,27,27,"2019-20",69.7674418604651
"4552",2020-01-17,"Minnesota Timberwolves",114,"Indiana Pacers",116,16248,1,2,2,"2019-20",65.7894736842105
"4553",2020-01-17,"Chicago Bulls",89,"Philadelphia 76ers",100,20919,1,11,11,"2019-20",83.7837837837838
"4554",2020-01-17,"Washington Wizards",111,"Toronto Raptors",140,19800,1,29,29,"2019-20",66.6666666666667
"4555",2020-01-17,"Cleveland Cavaliers",109,"Memphis Grizzlies",113,17102,1,4,4,"2019-20",54.0540540540541
"4556",2020-01-17,"Miami Heat",115,"Oklahoma City Thunder",108,18203,0,-7,7,"2019-20",65
"4557",2020-01-17,"Atlanta Hawks",121,"San Antonio Spurs",120,18354,0,-1,1,"2019-20",55.8823529411765
"4558",2020-01-17,"Portland Trail Blazers",112,"Dallas Mavericks",120,20283,1,8,8,"2019-20",51.219512195122
"4559",2020-01-18,"Los Angeles Clippers",133,"New Orleans Pelicans",130,17959,0,-3,3,"2019-20",41.6666666666667
"4560",2020-01-18,"Milwaukee Bucks",117,"Brooklyn Nets",97,17732,0,-20,20,"2019-20",52.6315789473684
"4561",2020-01-18,"Phoenix Suns",123,"Boston Celtics",119,19156,0,-4,4,"2019-20",65.9090909090909
"4562",2020-01-18,"Detroit Pistons",136,"Atlanta Hawks",103,17056,0,-33,33,"2019-20",41.1764705882353
"4563",2020-01-18,"Philadelphia 76ers",90,"New York Knicks",87,17812,0,-3,3,"2019-20",33.3333333333333
"4564",2020-01-18,"Cleveland Cavaliers",116,"Chicago Bulls",118,19939,1,2,2,"2019-20",41.1764705882353
"4565",2020-01-18,"Toronto Raptors",122,"Minnesota Timberwolves",112,16520,0,-10,10,"2019-20",25
"4566",2020-01-18,"Orlando Magic",95,"Golden State Warriors",109,18064,1,14,14,"2019-20",23.5294117647059
"4567",2020-01-18,"Los Angeles Lakers",124,"Houston Rockets",115,18502,0,-9,9,"2019-20",66.6666666666667
"4568",2020-01-18,"Portland Trail Blazers",106,"Oklahoma City Thunder",119,18203,1,13,13,"2019-20",65
"4569",2020-01-18,"Sacramento Kings",101,"Utah Jazz",123,18306,1,22,22,"2019-20",65.7894736842105
"4570",2020-01-19,"Miami Heat",102,"San Antonio Spurs",107,18422,1,5,5,"2019-20",55.8823529411765
"4571",2020-01-19,"Indiana Pacers",115,"Denver Nuggets",107,19520,0,-8,8,"2019-20",67.3913043478261
"4572",2020-01-20,"Detroit Pistons",100,"Washington Wizards",106,17305,1,6,6,"2019-20",44.4444444444444
"4573",2020-01-20,"Toronto Raptors",122,"Atlanta Hawks",117,17300,0,-5,5,"2019-20",41.1764705882353
"4574",2020-01-20,"Philadelphia 76ers",117,"Brooklyn Nets",111,16801,0,-6,6,"2019-20",52.6315789473684
"4575",2020-01-20,"Orlando Magic",106,"Charlotte Hornets",83,16133,0,-23,23,"2019-20",32.258064516129
"4576",2020-01-20,"New York Knicks",106,"Cleveland Cavaliers",86,17133,0,-20,20,"2019-20",30.5555555555556
"4577",2020-01-20,"Oklahoma City Thunder",112,"Houston Rockets",107,18055,0,-5,5,"2019-20",66.6666666666667
"4578",2020-01-20,"New Orleans Pelicans",126,"Memphis Grizzlies",116,17794,0,-10,10,"2019-20",54.0540540540541
"4579",2020-01-20,"Sacramento Kings",113,"Miami Heat",118,19600,1,5,5,"2019-20",76.0869565217391
"4580",2020-01-20,"Chicago Bulls",98,"Milwaukee Bucks",111,17747,1,13,13,"2019-20",78.0487804878049
"4581",2020-01-20,"Los Angeles Lakers",107,"Boston Celtics",139,19156,1,32,32,"2019-20",65.9090909090909
"4582",2020-01-20,"Denver Nuggets",107,"Minnesota Timberwolves",100,12172,0,-7,7,"2019-20",25
"4583",2020-01-20,"San Antonio Spurs",120,"Phoenix Suns",118,14847,0,-2,2,"2019-20",43.5897435897436
"4584",2020-01-20,"Indiana Pacers",88,"Utah Jazz",118,18306,1,30,30,"2019-20",65.7894736842105
"4585",2020-01-20,"Golden State Warriors",124,"Portland Trail Blazers",129,19493,1,5,5,"2019-20",56.4102564102564
"4586",2020-01-21,"Los Angeles Clippers",110,"Dallas Mavericks",107,19783,0,-3,3,"2019-20",51.219512195122
"4587",2020-01-22,"Sacramento Kings",106,"Detroit Pistons",127,13972,1,21,21,"2019-20",33.3333333333333
"4588",2020-01-22,"Oklahoma City Thunder",120,"Orlando Magic",114,18846,0,-6,6,"2019-20",48.6486486486487
"4589",2020-01-22,"Philadelphia 76ers",95,"Toronto Raptors",107,19800,1,12,12,"2019-20",66.6666666666667
"4590",2020-01-22,"Los Angeles Clippers",95,"Atlanta Hawks",102,14338,1,7,7,"2019-20",41.1764705882353
"4591",2020-01-22,"Memphis Grizzlies",95,"Boston Celtics",119,19156,1,24,24,"2019-20",65.9090909090909
"4592",2020-01-22,"Washington Wizards",129,"Miami Heat",134,19600,1,5,5,"2019-20",76.0869565217391
"4593",2020-01-22,"Los Angeles Lakers",100,"New York Knicks",92,19812,0,-8,8,"2019-20",33.3333333333333
"4594",2020-01-22,"Minnesota Timberwolves",110,"Chicago Bulls",117,18875,1,7,7,"2019-20",41.1764705882353
"4595",2020-01-22,"Denver Nuggets",105,"Houston Rockets",121,18055,1,16,16,"2019-20",66.6666666666667
"4596",2020-01-22,"Indiana Pacers",112,"Phoenix Suns",87,14691,0,-25,25,"2019-20",43.5897435897436
"4597",2020-01-22,"San Antonio Spurs",121,"New Orleans Pelicans",117,18365,0,-4,4,"2019-20",41.6666666666667
"4598",2020-01-22,"Utah Jazz",129,"Golden State Warriors",96,18064,0,-33,33,"2019-20",23.5294117647059
"4599",2020-01-23,"Washington Wizards",124,"Cleveland Cavaliers",112,16689,0,-12,12,"2019-20",30.5555555555556
"4600",2020-01-23,"Los Angeles Lakers",128,"Brooklyn Nets",113,17732,0,-15,15,"2019-20",52.6315789473684
"4601",2020-01-23,"Dallas Mavericks",133,"Portland Trail Blazers",125,19574,0,-8,8,"2019-20",56.4102564102564
"4602",2020-01-24,"Milwaukee Bucks",116,"Charlotte Hornets",103,15758,0,-13,13,"2019-20",32.258064516129
"4603",2020-01-24,"Memphis Grizzlies",125,"Detroit Pistons",112,14583,0,-13,13,"2019-20",33.3333333333333
"4604",2020-01-24,"Boston Celtics",109,"Orlando Magic",98,18846,0,-11,11,"2019-20",48.6486486486487
"4605",2020-01-24,"Toronto Raptors",118,"New York Knicks",112,18883,0,-6,6,"2019-20",33.3333333333333
"4606",2020-01-24,"Sacramento Kings",98,"Chicago Bulls",81,17661,0,-17,17,"2019-20",41.1764705882353
"4607",2020-01-24,"Los Angeles Clippers",122,"Miami Heat",117,19632,0,-5,5,"2019-20",76.0869565217391
"4608",2020-01-24,"Houston Rockets",131,"Minnesota Timberwolves",124,16101,0,-7,7,"2019-20",25
"4609",2020-01-24,"Denver Nuggets",113,"New Orleans Pelicans",106,16398,0,-7,7,"2019-20",41.6666666666667
"4610",2020-01-24,"Atlanta Hawks",111,"Oklahoma City Thunder",140,18203,1,29,29,"2019-20",65
"4611",2020-01-24,"Phoenix Suns",103,"San Antonio Spurs",99,18354,0,-4,4,"2019-20",55.8823529411765
"4612",2020-01-24,"Indiana Pacers",129,"Golden State Warriors",118,18064,0,-11,11,"2019-20",23.5294117647059
"4613",2020-01-25,"Dallas Mavericks",107,"Utah Jazz",112,18306,1,5,5,"2019-20",65.7894736842105
"4614",2020-01-25,"Brooklyn Nets",121,"Detroit Pistons",111,15890,0,-10,10,"2019-20",33.3333333333333
"4615",2020-01-25,"Chicago Bulls",118,"Cleveland Cavaliers",106,19432,0,-12,12,"2019-20",30.5555555555556
"4616",2020-01-25,"Oklahoma City Thunder",113,"Minnesota Timberwolves",104,16236,0,-9,9,"2019-20",25
"4617",2020-01-25,"Los Angeles Lakers",91,"Philadelphia 76ers",108,21109,1,17,17,"2019-20",83.7837837837838
"4618",2020-01-26,"Houston Rockets",110,"Denver Nuggets",117,19520,1,7,7,"2019-20",67.3913043478261
"4619",2020-01-26,"Toronto Raptors",110,"San Antonio Spurs",106,18354,0,-4,4,"2019-20",55.8823529411765
"4620",2020-01-26,"Washington Wizards",133,"Atlanta Hawks",152,15567,1,19,19,"2019-20",41.1764705882353
"4621",2020-01-26,"Phoenix Suns",109,"Memphis Grizzlies",114,17214,1,5,5,"2019-20",54.0540540540541
"4622",2020-01-26,"Boston Celtics",108,"New Orleans Pelicans",123,16737,1,15,15,"2019-20",41.6666666666667
"4623",2020-01-26,"Brooklyn Nets",97,"New York Knicks",110,17831,1,13,13,"2019-20",33.3333333333333
"4624",2020-01-26,"Los Angeles Clippers",112,"Orlando Magic",97,15427,0,-15,15,"2019-20",48.6486486486487
"4625",2020-01-26,"Indiana Pacers",129,"Portland Trail Blazers",139,19663,1,10,10,"2019-20",56.4102564102564
"4626",2020-01-27,"Cleveland Cavaliers",115,"Detroit Pistons",100,12597,0,-15,15,"2019-20",33.3333333333333
"4627",2020-01-27,"Orlando Magic",92,"Miami Heat",113,19600,1,21,21,"2019-20",76.0869565217391
"4628",2020-01-27,"San Antonio Spurs",109,"Chicago Bulls",110,16071,1,1,1,"2019-20",41.1764705882353
"4629",2020-01-27,"Sacramento Kings",133,"Minnesota Timberwolves",129,13449,0,-4,4,"2019-20",25
"4630",2020-01-27,"Dallas Mavericks",107,"Oklahoma City Thunder",97,18203,0,-10,10,"2019-20",65
"4631",2020-01-27,"Houston Rockets",126,"Utah Jazz",117,18306,0,-9,9,"2019-20",65.7894736842105
"4632",2020-01-28,"New York Knicks",92,"Charlotte Hornets",97,14342,1,5,5,"2019-20",32.258064516129
"4633",2020-01-28,"Golden State Warriors",104,"Philadelphia 76ers",115,20854,1,11,11,"2019-20",83.7837837837838
"4634",2020-01-28,"New Orleans Pelicans",125,"Cleveland Cavaliers",111,19432,0,-14,14,"2019-20",30.5555555555556
"4635",2020-01-28,"Atlanta Hawks",114,"Toronto Raptors",130,19800,1,16,16,"2019-20",66.6666666666667
"4636",2020-01-28,"Denver Nuggets",96,"Memphis Grizzlies",104,14365,1,8,8,"2019-20",54.0540540540541
"4637",2020-01-28,"Boston Celtics",109,"Miami Heat",101,19704,0,-8,8,"2019-20",76.0869565217391
"4638",2020-01-28,"Washington Wizards",131,"Milwaukee Bucks",151,17681,1,20,20,"2019-20",78.0487804878049
"4639",2020-01-28,"Phoenix Suns",133,"Dallas Mavericks",104,20216,0,-29,29,"2019-20",51.219512195122
"4640",2020-01-29,"Chicago Bulls",106,"Indiana Pacers",115,17923,1,9,9,"2019-20",65.7894736842105
"4641",2020-01-29,"Detroit Pistons",115,"Brooklyn Nets",125,14275,1,10,10,"2019-20",52.6315789473684
"4642",2020-01-29,"Memphis Grizzlies",127,"New York Knicks",106,18768,0,-21,21,"2019-20",33.3333333333333
"4643",2020-01-29,"Utah Jazz",120,"San Antonio Spurs",127,17887,1,7,7,"2019-20",55.8823529411765
"4644",2020-01-29,"Houston Rockets",112,"Portland Trail Blazers",125,19393,1,13,13,"2019-20",56.4102564102564
"4645",2020-01-29,"Oklahoma City Thunder",120,"Sacramento Kings",100,16935,0,-20,20,"2019-20",45.7142857142857
"4646",2020-01-30,"Toronto Raptors",115,"Cleveland Cavaliers",109,17695,0,-6,6,"2019-20",30.5555555555556
"4647",2020-01-30,"Charlotte Hornets",107,"Washington Wizards",121,15013,1,14,14,"2019-20",44.4444444444444
"4648",2020-01-30,"Philadelphia 76ers",117,"Atlanta Hawks",127,15227,1,10,10,"2019-20",41.1764705882353
"4649",2020-01-30,"Golden State Warriors",104,"Boston Celtics",119,19156,1,15,15,"2019-20",65.9090909090909
"4650",2020-01-30,"Utah Jazz",100,"Denver Nuggets",106,19520,1,6,6,"2019-20",67.3913043478261
"4651",2020-01-30,"Sacramento Kings",124,"Los Angeles Clippers",103,19068,0,-21,21,"2019-20",69.7674418604651
"4652",2020-01-31,"Toronto Raptors",105,"Detroit Pistons",92,17356,0,-13,13,"2019-20",33.3333333333333
"4653",2020-01-31,"Chicago Bulls",118,"Brooklyn Nets",133,17732,1,15,15,"2019-20",52.6315789473684
"4654",2020-01-31,"Dallas Mavericks",121,"Houston Rockets",128,18055,1,7,7,"2019-20",66.6666666666667
"4655",2020-01-31,"Memphis Grizzlies",111,"New Orleans Pelicans",139,18362,1,28,28,"2019-20",41.6666666666667
"4656",2020-01-31,"Denver Nuggets",127,"Milwaukee Bucks",115,18141,0,-12,12,"2019-20",78.0487804878049
"4657",2020-01-31,"Oklahoma City Thunder",111,"Phoenix Suns",107,17260,0,-4,4,"2019-20",43.5897435897436
"4658",2020-01-31,"Portland Trail Blazers",127,"Los Angeles Lakers",119,18997,0,-8,8,"2019-20",72.3404255319149
"4659",2020-02-01,"Minnesota Timberwolves",106,"Los Angeles Clippers",118,19068,1,12,12,"2019-20",69.7674418604651
"4660",2020-02-01,"New York Knicks",92,"Indiana Pacers",85,17923,0,-7,7,"2019-20",65.7894736842105
"4661",2020-02-01,"Miami Heat",102,"Orlando Magic",89,18846,0,-13,13,"2019-20",48.6486486486487
"4662",2020-02-01,"Golden State Warriors",131,"Cleveland Cavaliers",112,18410,0,-19,19,"2019-20",30.5555555555556
"4663",2020-02-01,"Brooklyn Nets",107,"Washington Wizards",113,18196,1,6,6,"2019-20",44.4444444444444
"4664",2020-02-01,"Philadelphia 76ers",95,"Boston Celtics",116,19156,1,21,21,"2019-20",65.9090909090909
"4665",2020-02-01,"Atlanta Hawks",100,"Dallas Mavericks",123,20328,1,23,23,"2019-20",51.219512195122
"4666",2020-02-01,"Charlotte Hornets",90,"San Antonio Spurs",114,18615,1,24,24,"2019-20",55.8823529411765
"4667",2020-02-01,"Los Angeles Lakers",129,"Sacramento Kings",113,17583,0,-16,16,"2019-20",45.7142857142857
"4668",2020-02-01,"Utah Jazz",107,"Portland Trail Blazers",124,19603,1,17,17,"2019-20",56.4102564102564
"4669",2020-02-02,"Denver Nuggets",123,"Detroit Pistons",128,15488,1,5,5,"2019-20",33.3333333333333
"4670",2020-02-02,"New Orleans Pelicans",109,"Houston Rockets",117,18055,1,8,8,"2019-20",66.6666666666667
"4671",2020-02-02,"Phoenix Suns",108,"Milwaukee Bucks",129,17754,1,21,21,"2019-20",78.0487804878049
"4672",2020-02-02,"Chicago Bulls",102,"Toronto Raptors",129,19800,1,27,27,"2019-20",66.6666666666667
"4673",2020-02-03,"Orlando Magic",112,"Charlotte Hornets",100,12337,0,-12,12,"2019-20",32.258064516129
"4674",2020-02-03,"New York Knicks",139,"Cleveland Cavaliers",134,16303,0,-5,5,"2019-20",30.5555555555556
"4675",2020-02-03,"Dallas Mavericks",112,"Indiana Pacers",103,15086,0,-9,9,"2019-20",65.7894736842105
"4676",2020-02-03,"Golden State Warriors",125,"Washington Wizards",117,17120,0,-8,8,"2019-20",44.4444444444444
"4677",2020-02-03,"Boston Celtics",123,"Atlanta Hawks",115,16231,0,-8,8,"2019-20",41.1764705882353
"4678",2020-02-03,"Phoenix Suns",97,"Brooklyn Nets",119,14891,1,22,22,"2019-20",52.6315789473684
"4679",2020-02-03,"Philadelphia 76ers",106,"Miami Heat",137,19725,1,31,31,"2019-20",76.0869565217391
"4680",2020-02-03,"Detroit Pistons",82,"Memphis Grizzlies",96,14597,1,14,14,"2019-20",54.0540540540541
"4681",2020-02-03,"Minnesota Timberwolves",109,"Sacramento Kings",113,15819,1,4,4,"2019-20",45.7142857142857
"4682",2020-02-03,"San Antonio Spurs",105,"Los Angeles Clippers",108,19068,1,3,3,"2019-20",69.7674418604651
"4683",2020-02-04,"Milwaukee Bucks",120,"New Orleans Pelicans",108,15424,0,-12,12,"2019-20",41.6666666666667
"4684",2020-02-04,"Charlotte Hornets",110,"Houston Rockets",125,18055,1,15,15,"2019-20",66.6666666666667
"4685",2020-02-04,"Portland Trail Blazers",99,"Denver Nuggets",127,19520,1,28,28,"2019-20",67.3913043478261
"4686",2020-02-04,"San Antonio Spurs",102,"Los Angeles Lakers",129,18997,1,27,27,"2019-20",72.3404255319149
"4687",2020-02-05,"Phoenix Suns",108,"Detroit Pistons",116,13707,1,8,8,"2019-20",33.3333333333333
"4688",2020-02-05,"Orlando Magic",100,"Boston Celtics",116,19156,1,16,16,"2019-20",65.9090909090909
"4689",2020-02-05,"Golden State Warriors",88,"Brooklyn Nets",129,14352,1,41,41,"2019-20",52.6315789473684
"4690",2020-02-05,"Indiana Pacers",118,"Toronto Raptors",119,19800,1,1,1,"2019-20",66.6666666666667
"4691",2020-02-05,"Atlanta Hawks",127,"Minnesota Timberwolves",120,10779,0,-7,7,"2019-20",25
"4692",2020-02-05,"Cleveland Cavaliers",103,"Oklahoma City Thunder",109,18203,1,6,6,"2019-20",65
"4693",2020-02-05,"Memphis Grizzlies",121,"Dallas Mavericks",107,20069,0,-14,14,"2019-20",51.219512195122
"4694",2020-02-05,"Denver Nuggets",98,"Utah Jazz",95,18306,0,-3,3,"2019-20",65.7894736842105
"4695",2020-02-05,"Miami Heat",111,"Los Angeles Clippers",128,19068,1,17,17,"2019-20",69.7674418604651
"4696",2020-02-06,"Orlando Magic",103,"New York Knicks",105,18895,1,2,2,"2019-20",33.3333333333333
"4697",2020-02-06,"New Orleans Pelicans",125,"Chicago Bulls",119,18247,0,-6,6,"2019-20",41.1764705882353
"4698",2020-02-06,"Philadelphia 76ers",101,"Milwaukee Bucks",112,17928,1,11,11,"2019-20",78.0487804878049
"4699",2020-02-06,"San Antonio Spurs",117,"Portland Trail Blazers",125,19653,1,8,8,"2019-20",56.4102564102564
"4700",2020-02-06,"Houston Rockets",121,"Los Angeles Lakers",111,18997,0,-10,10,"2019-20",72.3404255319149
"4701",2020-02-07,"Memphis Grizzlies",107,"Philadelphia 76ers",119,20779,1,12,12,"2019-20",83.7837837837838
"4702",2020-02-07,"Dallas Mavericks",118,"Washington Wizards",119,20476,1,1,1,"2019-20",44.4444444444444
"4703",2020-02-07,"Atlanta Hawks",107,"Boston Celtics",112,19156,1,5,5,"2019-20",65.9090909090909
"4704",2020-02-07,"Toronto Raptors",115,"Indiana Pacers",106,17028,0,-9,9,"2019-20",65.7894736842105
"4705",2020-02-07,"Detroit Pistons",101,"Oklahoma City Thunder",108,18203,1,7,7,"2019-20",65
"4706",2020-02-07,"Houston Rockets",91,"Phoenix Suns",127,17043,1,36,36,"2019-20",43.5897435897436
"4707",2020-02-07,"Miami Heat",97,"Sacramento Kings",105,16760,1,8,8,"2019-20",45.7142857142857
"4708",2020-02-07,"Portland Trail Blazers",114,"Utah Jazz",117,18306,1,3,3,"2019-20",65.7894736842105
"4709",2020-02-08,"Milwaukee Bucks",111,"Orlando Magic",95,16632,0,-16,16,"2019-20",48.6486486486487
"4710",2020-02-08,"Dallas Mavericks",116,"Charlotte Hornets",100,19370,0,-16,16,"2019-20",32.258064516129
"4711",2020-02-08,"New York Knicks",95,"Detroit Pistons",92,15980,0,-3,3,"2019-20",33.3333333333333
"4712",2020-02-08,"New Orleans Pelicans",124,"Indiana Pacers",117,17923,0,-7,7,"2019-20",65.7894736842105
"4713",2020-02-08,"Brooklyn Nets",118,"Toronto Raptors",119,19800,1,1,1,"2019-20",66.6666666666667
"4714",2020-02-08,"Los Angeles Clippers",115,"Minnesota Timberwolves",142,18978,1,27,27,"2019-20",25
"4715",2020-02-08,"Los Angeles Lakers",125,"Golden State Warriors",120,18064,0,-5,5,"2019-20",23.5294117647059
"4716",2020-02-08,"Denver Nuggets",117,"Phoenix Suns",108,16843,0,-9,9,"2019-20",43.5897435897436
"4717",2020-02-08,"San Antonio Spurs",102,"Sacramento Kings",122,16756,1,20,20,"2019-20",45.7142857142857
"4718",2020-02-09,"Boston Celtics",112,"Oklahoma City Thunder",111,18203,0,-1,1,"2019-20",65
"4719",2020-02-09,"New York Knicks",135,"Atlanta Hawks",140,16309,1,5,5,"2019-20",41.1764705882353
"4720",2020-02-09,"Chicago Bulls",111,"Philadelphia 76ers",118,21018,1,7,7,"2019-20",83.7837837837838
"4721",2020-02-09,"Memphis Grizzlies",106,"Washington Wizards",99,17251,0,-7,7,"2019-20",44.4444444444444
"4722",2020-02-09,"Utah Jazz",114,"Houston Rockets",113,18055,0,-1,1,"2019-20",66.6666666666667
"4723",2020-02-09,"Los Angeles Clippers",133,"Cleveland Cavaliers",92,17240,0,-41,41,"2019-20",30.5555555555556
"4724",2020-02-09,"Miami Heat",109,"Portland Trail Blazers",115,19726,1,6,6,"2019-20",56.4102564102564
"4725",2020-02-10,"Charlotte Hornets",87,"Detroit Pistons",76,13941,0,-11,11,"2019-20",33.3333333333333
"4726",2020-02-10,"Brooklyn Nets",106,"Indiana Pacers",105,16761,0,-1,1,"2019-20",65.7894736842105
"4727",2020-02-10,"Atlanta Hawks",126,"Orlando Magic",135,17076,1,9,9,"2019-20",48.6486486486487
"4728",2020-02-10,"Minnesota Timberwolves",126,"Toronto Raptors",137,19800,1,11,11,"2019-20",66.6666666666667
"4729",2020-02-10,"Sacramento Kings",111,"Milwaukee Bucks",123,17463,1,12,12,"2019-20",78.0487804878049
"4730",2020-02-10,"Utah Jazz",123,"Dallas Mavericks",119,19793,0,-4,4,"2019-20",51.219512195122
"4731",2020-02-10,"San Antonio Spurs",120,"Denver Nuggets",127,19520,1,7,7,"2019-20",67.3913043478261
"4732",2020-02-10,"Miami Heat",113,"Golden State Warriors",101,18064,0,-12,12,"2019-20",23.5294117647059
"4733",2020-02-10,"Phoenix Suns",100,"Los Angeles Lakers",125,18997,1,25,25,"2019-20",72.3404255319149
"4734",2020-02-11,"Los Angeles Clippers",103,"Philadelphia 76ers",110,20730,1,7,7,"2019-20",83.7837837837838
"4735",2020-02-11,"Chicago Bulls",114,"Washington Wizards",126,15135,1,12,12,"2019-20",44.4444444444444
"4736",2020-02-11,"Portland Trail Blazers",117,"New Orleans Pelicans",138,15739,1,21,21,"2019-20",41.6666666666667
"4737",2020-02-11,"San Antonio Spurs",114,"Oklahoma City Thunder",106,18203,0,-8,8,"2019-20",65
"4738",2020-02-11,"Boston Celtics",105,"Houston Rockets",116,18055,1,11,11,"2019-20",66.6666666666667
"4739",2020-02-12,"Atlanta Hawks",105,"Cleveland Cavaliers",127,16200,1,22,22,"2019-20",30.5555555555556
"4740",2020-02-12,"Detroit Pistons",112,"Orlando Magic",116,16607,1,4,4,"2019-20",48.6486486486487
"4741",2020-02-12,"Toronto Raptors",91,"Brooklyn Nets",101,15823,1,10,10,"2019-20",52.6315789473684
"4742",2020-02-12,"Milwaukee Bucks",111,"Indiana Pacers",118,17018,1,7,7,"2019-20",65.7894736842105
"4743",2020-02-12,"Washington Wizards",114,"New York Knicks",96,18835,0,-18,18,"2019-20",33.3333333333333
"4744",2020-02-12,"Portland Trail Blazers",104,"Memphis Grizzlies",111,16889,1,7,7,"2019-20",54.0540540540541
"4745",2020-02-12,"Charlotte Hornets",115,"Minnesota Timberwolves",108,18978,0,-7,7,"2019-20",25
"4746",2020-02-12,"Sacramento Kings",111,"Dallas Mavericks",130,19842,1,19,19,"2019-20",51.219512195122
"4747",2020-02-12,"Golden State Warriors",106,"Phoenix Suns",112,15216,1,6,6,"2019-20",43.5897435897436
"4748",2020-02-12,"Miami Heat",101,"Utah Jazz",116,18306,1,15,15,"2019-20",65.7894736842105
"4749",2020-02-12,"Los Angeles Lakers",120,"Denver Nuggets",116,19860,0,-4,4,"2019-20",67.3913043478261
"4750",2020-02-13,"Los Angeles Clippers",133,"Boston Celtics",141,19156,1,8,8,"2019-20",65.9090909090909
"4751",2020-02-13,"Oklahoma City Thunder",123,"New Orleans Pelicans",118,17865,0,-5,5,"2019-20",41.6666666666667
"4752",2020-02-20,"Milwaukee Bucks",126,"Detroit Pistons",106,16097,0,-20,20,"2019-20",33.3333333333333
"4753",2020-02-20,"Miami Heat",124,"Atlanta Hawks",129,17356,1,5,5,"2019-20",41.1764705882353
"4754",2020-02-20,"Charlotte Hornets",103,"Chicago Bulls",93,17463,0,-10,10,"2019-20",41.1764705882353
"4755",2020-02-20,"Brooklyn Nets",104,"Philadelphia 76ers",112,20806,1,8,8,"2019-20",83.7837837837838
"4756",2020-02-20,"Memphis Grizzlies",125,"Sacramento Kings",129,17078,1,4,4,"2019-20",45.7142857142857
"4757",2020-02-20,"Houston Rockets",135,"Golden State Warriors",105,18064,0,-30,30,"2019-20",23.5294117647059
"4758",2020-02-21,"Dallas Mavericks",122,"Orlando Magic",106,18846,0,-16,16,"2019-20",48.6486486486487
"4759",2020-02-21,"Cleveland Cavaliers",113,"Washington Wizards",108,18895,0,-5,5,"2019-20",44.4444444444444
"4760",2020-02-21,"Indiana Pacers",106,"New York Knicks",98,19812,0,-8,8,"2019-20",33.3333333333333
"4761",2020-02-21,"Phoenix Suns",101,"Toronto Raptors",118,19800,1,17,17,"2019-20",66.6666666666667
"4762",2020-02-21,"Boston Celtics",127,"Minnesota Timberwolves",117,18978,0,-10,10,"2019-20",25
"4763",2020-02-21,"Denver Nuggets",101,"Oklahoma City Thunder",113,18203,1,12,12,"2019-20",65
"4764",2020-02-21,"San Antonio Spurs",113,"Utah Jazz",104,18306,0,-9,9,"2019-20",65.7894736842105
"4765",2020-02-21,"Memphis Grizzlies",105,"Los Angeles Lakers",117,18997,1,12,12,"2019-20",72.3404255319149
"4766",2020-02-21,"New Orleans Pelicans",128,"Portland Trail Blazers",115,19946,0,-13,13,"2019-20",56.4102564102564
"4767",2020-02-22,"Sacramento Kings",112,"Los Angeles Clippers",103,19068,0,-9,9,"2019-20",69.7674418604651
"4768",2020-02-22,"Brooklyn Nets",115,"Charlotte Hornets",86,19079,0,-29,29,"2019-20",32.258064516129
"4769",2020-02-22,"Dallas Mavericks",107,"Atlanta Hawks",111,17050,1,4,4,"2019-20",41.1764705882353
"4770",2020-02-22,"Phoenix Suns",112,"Chicago Bulls",104,20506,0,-8,8,"2019-20",41.1764705882353
"4771",2020-02-22,"Cleveland Cavaliers",105,"Miami Heat",124,19754,1,19,19,"2019-20",76.0869565217391
"4772",2020-02-22,"Philadelphia 76ers",98,"Milwaukee Bucks",119,18290,1,21,21,"2019-20",78.0487804878049
"4773",2020-02-22,"Houston Rockets",120,"Utah Jazz",110,18306,0,-10,10,"2019-20",65.7894736842105
"4774",2020-02-23,"Boston Celtics",112,"Los Angeles Lakers",114,18997,1,2,2,"2019-20",72.3404255319149
"4775",2020-02-23,"Minnesota Timberwolves",116,"Denver Nuggets",128,19626,1,12,12,"2019-20",67.3913043478261
"4776",2020-02-23,"Indiana Pacers",81,"Toronto Raptors",127,19800,1,46,46,"2019-20",66.6666666666667
"4777",2020-02-23,"Washington Wizards",117,"Chicago Bulls",126,18024,1,9,9,"2019-20",41.1764705882353
"4778",2020-02-23,"San Antonio Spurs",103,"Oklahoma City Thunder",131,18203,1,28,28,"2019-20",65
"4779",2020-02-23,"New Orleans Pelicans",115,"Golden State Warriors",101,18064,0,-14,14,"2019-20",23.5294117647059
"4780",2020-02-23,"Detroit Pistons",104,"Portland Trail Blazers",107,19393,1,3,3,"2019-20",56.4102564102564
"4781",2020-02-24,"Miami Heat",119,"Cleveland Cavaliers",125,17336,1,6,6,"2019-20",30.5555555555556
"4782",2020-02-24,"Atlanta Hawks",112,"Philadelphia 76ers",129,20836,1,17,17,"2019-20",83.7837837837838
"4783",2020-02-24,"Milwaukee Bucks",137,"Washington Wizards",134,16580,0,-3,3,"2019-20",44.4444444444444
"4784",2020-02-24,"Orlando Magic",115,"Brooklyn Nets",113,16162,0,-2,2,"2019-20",52.6315789473684
"4785",2020-02-24,"New York Knicks",112,"Houston Rockets",123,18055,1,11,11,"2019-20",66.6666666666667
"4786",2020-02-24,"Minnesota Timberwolves",123,"Dallas Mavericks",139,19936,1,16,16,"2019-20",51.219512195122
"4787",2020-02-24,"Phoenix Suns",131,"Utah Jazz",111,18306,0,-20,20,"2019-20",65.7894736842105
"4788",2020-02-24,"Memphis Grizzlies",97,"Los Angeles Clippers",124,19068,1,27,27,"2019-20",69.7674418604651
"4789",2020-02-25,"Charlotte Hornets",80,"Indiana Pacers",119,16088,1,39,39,"2019-20",65.7894736842105
"4790",2020-02-25,"Milwaukee Bucks",108,"Toronto Raptors",97,19993,0,-11,11,"2019-20",66.6666666666667
"4791",2020-02-25,"Oklahoma City Thunder",124,"Chicago Bulls",122,16911,0,-2,2,"2019-20",41.1764705882353
"4792",2020-02-25,"Detroit Pistons",98,"Denver Nuggets",115,19143,1,17,17,"2019-20",67.3913043478261
"4793",2020-02-25,"New Orleans Pelicans",109,"Los Angeles Lakers",118,18997,1,9,9,"2019-20",72.3404255319149
"4794",2020-02-25,"Boston Celtics",118,"Portland Trail Blazers",106,19460,0,-12,12,"2019-20",56.4102564102564
"4795",2020-02-25,"Sacramento Kings",112,"Golden State Warriors",94,18064,0,-18,18,"2019-20",23.5294117647059
"4796",2020-02-26,"New York Knicks",101,"Charlotte Hornets",107,13152,1,6,6,"2019-20",32.258064516129
"4797",2020-02-26,"Philadelphia 76ers",94,"Cleveland Cavaliers",108,16332,1,14,14,"2019-20",30.5555555555556
"4798",2020-02-26,"Brooklyn Nets",106,"Washington Wizards",110,15021,1,4,4,"2019-20",44.4444444444444
"4799",2020-02-26,"Orlando Magic",130,"Atlanta Hawks",120,14967,0,-10,10,"2019-20",41.1764705882353
"4800",2020-02-26,"Minnesota Timberwolves",129,"Miami Heat",126,19600,0,-3,3,"2019-20",76.0869565217391
"4801",2020-02-26,"Memphis Grizzlies",112,"Houston Rockets",140,18055,1,28,28,"2019-20",66.6666666666667
"4802",2020-02-26,"Dallas Mavericks",109,"San Antonio Spurs",103,18354,0,-6,6,"2019-20",55.8823529411765
"4803",2020-02-26,"Los Angeles Clippers",102,"Phoenix Suns",92,15157,0,-10,10,"2019-20",43.5897435897436
"4804",2020-02-26,"Boston Celtics",114,"Utah Jazz",103,18306,0,-11,11,"2019-20",65.7894736842105
"4805",2020-02-27,"New York Knicks",106,"Philadelphia 76ers",115,20175,1,9,9,"2019-20",83.7837837837838
"4806",2020-02-27,"Portland Trail Blazers",100,"Indiana Pacers",106,16872,1,6,6,"2019-20",65.7894736842105
"4807",2020-02-27,"Sacramento Kings",108,"Oklahoma City Thunder",112,18203,1,4,4,"2019-20",65
"4808",2020-02-27,"Los Angeles Lakers",116,"Golden State Warriors",86,18064,0,-30,30,"2019-20",23.5294117647059
"4809",2020-02-28,"Minnesota Timberwolves",125,"Orlando Magic",136,18846,1,11,11,"2019-20",48.6486486486487
"4810",2020-02-28,"Brooklyn Nets",118,"Atlanta Hawks",141,17034,1,23,23,"2019-20",41.1764705882353
"4811",2020-02-28,"Charlotte Hornets",99,"Toronto Raptors",96,19800,0,-3,3,"2019-20",66.6666666666667
"4812",2020-02-28,"Sacramento Kings",104,"Memphis Grizzlies",101,17794,0,-3,3,"2019-20",54.0540540540541
"4813",2020-02-28,"Dallas Mavericks",118,"Miami Heat",126,19704,1,8,8,"2019-20",76.0869565217391
"4814",2020-02-28,"Oklahoma City Thunder",86,"Milwaukee Bucks",133,18412,1,47,47,"2019-20",78.0487804878049
"4815",2020-02-28,"Cleveland Cavaliers",104,"New Orleans Pelicans",116,18304,1,12,12,"2019-20",41.6666666666667
"4816",2020-02-28,"Detroit Pistons",113,"Phoenix Suns",111,17142,0,-2,2,"2019-20",43.5897435897436
"4817",2020-02-28,"Washington Wizards",119,"Utah Jazz",129,18306,1,10,10,"2019-20",65.7894736842105
"4818",2020-02-28,"Denver Nuggets",103,"Los Angeles Clippers",132,19068,1,29,29,"2019-20",69.7674418604651
"4819",2020-02-29,"Chicago Bulls",115,"New York Knicks",125,19812,1,10,10,"2019-20",33.3333333333333
"4820",2020-02-29,"Portland Trail Blazers",117,"Atlanta Hawks",129,17765,1,12,12,"2019-20",41.1764705882353
"4821",2020-02-29,"Brooklyn Nets",113,"Miami Heat",116,19600,1,3,3,"2019-20",76.0869565217391
"4822",2020-02-29,"Indiana Pacers",113,"Cleveland Cavaliers",104,19432,0,-9,9,"2019-20",30.5555555555556
"4823",2020-02-29,"Los Angeles Lakers",88,"Memphis Grizzlies",105,17794,1,17,17,"2019-20",54.0540540540541
"4824",2020-02-29,"Houston Rockets",111,"Boston Celtics",110,19156,0,-1,1,"2019-20",65.9090909090909
"4825",2020-02-29,"Orlando Magic",113,"San Antonio Spurs",114,18354,1,1,1,"2019-20",55.8823529411765
"4826",2020-02-29,"Golden State Warriors",115,"Phoenix Suns",99,16395,0,-16,16,"2019-20",43.5897435897436
"4827",2020-03-01,"Milwaukee Bucks",93,"Charlotte Hornets",85,19149,0,-8,8,"2019-20",32.258064516129
"4828",2020-03-01,"Philadelphia 76ers",130,"Los Angeles Clippers",136,19068,1,6,6,"2019-20",69.7674418604651
"4829",2020-03-01,"Dallas Mavericks",111,"Minnesota Timberwolves",91,18058,0,-20,20,"2019-20",25
"4830",2020-03-01,"Toronto Raptors",118,"Denver Nuggets",133,19777,1,15,15,"2019-20",67.3913043478261
"4831",2020-03-01,"Detroit Pistons",100,"Sacramento Kings",106,17499,1,6,6,"2019-20",45.7142857142857
"4832",2020-03-01,"Los Angeles Lakers",122,"New Orleans Pelicans",114,18547,0,-8,8,"2019-20",41.6666666666667
"4833",2020-03-01,"Washington Wizards",124,"Golden State Warriors",110,18064,0,-14,14,"2019-20",23.5294117647059
"4834",2020-03-02,"Utah Jazz",126,"Cleveland Cavaliers",113,15453,0,-13,13,"2019-20",30.5555555555556
"4835",2020-03-02,"Houston Rockets",123,"New York Knicks",125,18142,1,2,2,"2019-20",33.3333333333333
"4836",2020-03-02,"Portland Trail Blazers",130,"Orlando Magic",107,18078,0,-23,23,"2019-20",48.6486486486487
"4837",2020-03-02,"Memphis Grizzlies",127,"Atlanta Hawks",88,16207,0,-39,39,"2019-20",41.1764705882353
"4838",2020-03-02,"Milwaukee Bucks",89,"Miami Heat",105,19600,1,16,16,"2019-20",76.0869565217391
"4839",2020-03-02,"Dallas Mavericks",107,"Chicago Bulls",109,18407,1,2,2,"2019-20",41.1764705882353
"4840",2020-03-02,"Indiana Pacers",116,"San Antonio Spurs",111,17635,0,-5,5,"2019-20",55.8823529411765
"4841",2020-03-03,"San Antonio Spurs",104,"Charlotte Hornets",103,12008,0,-1,1,"2019-20",32.258064516129
"4842",2020-03-03,"Brooklyn Nets",129,"Boston Celtics",120,19156,0,-9,9,"2019-20",65.9090909090909
"4843",2020-03-03,"Minnesota Timberwolves",139,"New Orleans Pelicans",134,15264,0,-5,5,"2019-20",41.6666666666667
"4844",2020-03-03,"Los Angeles Clippers",109,"Oklahoma City Thunder",94,18203,0,-15,15,"2019-20",65
"4845",2020-03-03,"Golden State Warriors",116,"Denver Nuggets",100,19520,0,-16,16,"2019-20",67.3913043478261
"4846",2020-03-03,"Toronto Raptors",123,"Phoenix Suns",114,15553,0,-9,9,"2019-20",43.5897435897436
"4847",2020-03-03,"Philadelphia 76ers",107,"Los Angeles Lakers",120,18997,1,13,13,"2019-20",72.3404255319149
"4848",2020-03-03,"Washington Wizards",126,"Sacramento Kings",133,16419,1,7,7,"2019-20",45.7142857142857
"4849",2020-03-04,"Boston Celtics",112,"Cleveland Cavaliers",106,16897,0,-6,6,"2019-20",30.5555555555556
"4850",2020-03-04,"Oklahoma City Thunder",114,"Detroit Pistons",107,15138,0,-7,7,"2019-20",33.3333333333333
"4851",2020-03-04,"Indiana Pacers",100,"Milwaukee Bucks",119,17695,1,19,19,"2019-20",78.0487804878049
"4852",2020-03-04,"Memphis Grizzlies",118,"Brooklyn Nets",79,16941,0,-39,39,"2019-20",52.6315789473684
"4853",2020-03-04,"Utah Jazz",112,"New York Knicks",104,16588,0,-8,8,"2019-20",33.3333333333333
"4854",2020-03-04,"Orlando Magic",113,"Miami Heat",116,19600,1,3,3,"2019-20",76.0869565217391
"4855",2020-03-04,"Chicago Bulls",108,"Minnesota Timberwolves",115,13392,1,7,7,"2019-20",25
"4856",2020-03-04,"New Orleans Pelicans",123,"Dallas Mavericks",127,20459,1,4,4,"2019-20",51.219512195122
"4857",2020-03-04,"Washington Wizards",104,"Portland Trail Blazers",125,19393,1,21,21,"2019-20",56.4102564102564
"4858",2020-03-05,"Denver Nuggets",114,"Charlotte Hornets",112,13311,0,-2,2,"2019-20",32.258064516129
"4859",2020-03-05,"Los Angeles Clippers",120,"Houston Rockets",105,18055,0,-15,15,"2019-20",66.6666666666667
"4860",2020-03-05,"Philadelphia 76ers",125,"Sacramento Kings",108,15485,0,-17,17,"2019-20",45.7142857142857
"4861",2020-03-05,"Toronto Raptors",121,"Golden State Warriors",113,18064,0,-8,8,"2019-20",23.5294117647059
"4862",2020-03-06,"Atlanta Hawks",112,"Washington Wizards",118,17856,1,6,6,"2019-20",44.4444444444444
"4863",2020-03-06,"San Antonio Spurs",120,"Brooklyn Nets",139,16277,1,19,19,"2019-20",52.6315789473684
"4864",2020-03-06,"Oklahoma City Thunder",126,"New York Knicks",103,19499,0,-23,23,"2019-20",33.3333333333333
"4865",2020-03-06,"Indiana Pacers",108,"Chicago Bulls",102,20229,0,-6,6,"2019-20",41.1764705882353
"4866",2020-03-06,"Orlando Magic",132,"Minnesota Timberwolves",118,14315,0,-14,14,"2019-20",25
"4867",2020-03-06,"Miami Heat",104,"New Orleans Pelicans",110,18384,1,6,6,"2019-20",41.6666666666667
"4868",2020-03-06,"Utah Jazz",99,"Boston Celtics",94,19156,0,-5,5,"2019-20",65.9090909090909
"4869",2020-03-06,"Memphis Grizzlies",96,"Dallas Mavericks",121,20370,1,25,25,"2019-20",51.219512195122
"4870",2020-03-06,"Portland Trail Blazers",117,"Phoenix Suns",127,15522,1,10,10,"2019-20",43.5897435897436
"4871",2020-03-06,"Milwaukee Bucks",103,"Los Angeles Lakers",113,18997,1,10,10,"2019-20",72.3404255319149
"4872",2020-03-07,"Houston Rockets",99,"Charlotte Hornets",108,19159,1,9,9,"2019-20",32.258064516129
"4873",2020-03-07,"Utah Jazz",111,"Detroit Pistons",105,16590,0,-6,6,"2019-20",33.3333333333333
"4874",2020-03-07,"Denver Nuggets",102,"Cleveland Cavaliers",104,19432,1,2,2,"2019-20",30.5555555555556
"4875",2020-03-07,"Atlanta Hawks",101,"Memphis Grizzlies",118,17117,1,17,17,"2019-20",54.0540540540541
"4876",2020-03-07,"Philadelphia 76ers",114,"Golden State Warriors",118,18064,1,4,4,"2019-20",23.5294117647059
"4877",2020-03-07,"Sacramento Kings",123,"Portland Trail Blazers",111,19691,0,-12,12,"2019-20",56.4102564102564
"4878",2020-03-08,"Chicago Bulls",107,"Brooklyn Nets",110,15916,1,3,3,"2019-20",52.6315789473684
"4879",2020-03-08,"New Orleans Pelicans",120,"Minnesota Timberwolves",107,18978,0,-13,13,"2019-20",25
"4880",2020-03-08,"Los Angeles Lakers",112,"Los Angeles Clippers",103,19068,0,-9,9,"2019-20",69.7674418604651
"4881",2020-03-08,"Oklahoma City Thunder",105,"Boston Celtics",104,19156,0,-1,1,"2019-20",65.9090909090909
"4882",2020-03-08,"Milwaukee Bucks",131,"Phoenix Suns",140,17282,1,9,9,"2019-20",43.5897435897436
"4883",2020-03-08,"Miami Heat",100,"Washington Wizards",89,18135,0,-11,11,"2019-20",44.4444444444444
"4884",2020-03-08,"Indiana Pacers",112,"Dallas Mavericks",109,20324,0,-3,3,"2019-20",51.219512195122
"4885",2020-03-08,"Orlando Magic",126,"Houston Rockets",106,18055,0,-20,20,"2019-20",66.6666666666667
"4886",2020-03-08,"Detroit Pistons",84,"New York Knicks",96,18361,1,12,12,"2019-20",33.3333333333333
"4887",2020-03-08,"San Antonio Spurs",129,"Cleveland Cavaliers",132,17995,1,3,3,"2019-20",30.5555555555556
"4888",2020-03-08,"Toronto Raptors",118,"Sacramento Kings",113,16449,0,-5,5,"2019-20",45.7142857142857
"4889",2020-03-09,"Charlotte Hornets",138,"Atlanta Hawks",143,14399,1,5,5,"2019-20",41.1764705882353
"4890",2020-03-09,"Milwaukee Bucks",95,"Denver Nuggets",109,19838,1,14,14,"2019-20",67.3913043478261
"4891",2020-03-09,"Toronto Raptors",101,"Utah Jazz",92,18306,0,-9,9,"2019-20",65.7894736842105
"4892",2020-03-10,"New York Knicks",115,"Washington Wizards",122,15048,1,7,7,"2019-20",44.4444444444444
"4893",2020-03-10,"Boston Celtics",114,"Indiana Pacers",111,17053,0,-3,3,"2019-20",65.7894736842105
"4894",2020-03-10,"Minnesota Timberwolves",111,"Houston Rockets",117,18055,1,6,6,"2019-20",66.6666666666667
"4895",2020-03-10,"Dallas Mavericks",109,"San Antonio Spurs",119,18354,1,10,10,"2019-20",55.8823529411765
"4896",2020-03-10,"Orlando Magic",120,"Memphis Grizzlies",115,15388,0,-5,5,"2019-20",54.0540540540541
"4897",2020-03-10,"Cleveland Cavaliers",103,"Chicago Bulls",108,17837,1,5,5,"2019-20",41.1764705882353
"4898",2020-03-10,"Phoenix Suns",105,"Portland Trail Blazers",121,19393,1,16,16,"2019-20",56.4102564102564
"4899",2020-03-10,"Brooklyn Nets",104,"Los Angeles Lakers",102,18997,0,-2,2,"2019-20",72.3404255319149
"4900",2020-03-10,"Los Angeles Clippers",131,"Golden State Warriors",107,18064,0,-24,24,"2019-20",23.5294117647059
"4901",2020-03-11,"Detroit Pistons",106,"Philadelphia 76ers",124,20172,1,18,18,"2019-20",83.7837837837838
"4902",2020-03-11,"New York Knicks",136,"Atlanta Hawks",131,15393,0,-5,5,"2019-20",41.1764705882353
"4903",2020-03-11,"Charlotte Hornets",109,"Miami Heat",98,19600,0,-11,11,"2019-20",76.0869565217391
"4904",2020-03-11,"Denver Nuggets",97,"Dallas Mavericks",113,20302,1,16,16,"2019-20",51.219512195122
"4905",2020-07-30,"Utah Jazz",106,"New Orleans Pelicans",104,0,0,-2,2,"2019-20",41.6666666666667
"4906",2020-07-30,"Los Angeles Clippers",101,"Los Angeles Lakers",103,0,1,2,2,"2019-20",72.3404255319149
"4907",2020-07-31,"Orlando Magic",128,"Brooklyn Nets",118,0,0,-10,10,"2019-20",52.6315789473684
"4908",2020-07-31,"Memphis Grizzlies",135,"Portland Trail Blazers",140,0,1,5,5,"2019-20",56.4102564102564
"4909",2020-07-31,"Phoenix Suns",125,"Washington Wizards",112,0,0,-13,13,"2019-20",44.4444444444444
"4910",2020-07-31,"Boston Celtics",112,"Milwaukee Bucks",119,0,1,7,7,"2019-20",78.0487804878049
"4911",2020-07-31,"Sacramento Kings",120,"San Antonio Spurs",129,0,1,9,9,"2019-20",55.8823529411765
"4912",2020-07-31,"Houston Rockets",153,"Dallas Mavericks",149,0,0,-4,4,"2019-20",51.219512195122
"4913",2020-08-01,"Miami Heat",125,"Denver Nuggets",105,0,0,-20,20,"2019-20",67.3913043478261
"4914",2020-08-01,"Utah Jazz",94,"Oklahoma City Thunder",110,0,1,16,16,"2019-20",65
"4915",2020-08-01,"New Orleans Pelicans",103,"Los Angeles Clippers",126,0,1,23,23,"2019-20",69.7674418604651
"4916",2020-08-01,"Philadelphia 76ers",121,"Indiana Pacers",127,0,1,6,6,"2019-20",65.7894736842105
"4917",2020-08-01,"Los Angeles Lakers",92,"Toronto Raptors",107,0,1,15,15,"2019-20",66.6666666666667
"4918",2020-08-02,"Washington Wizards",110,"Brooklyn Nets",118,0,1,8,8,"2019-20",52.6315789473684
"4919",2020-08-02,"Portland Trail Blazers",124,"Boston Celtics",128,0,1,4,4,"2019-20",65.9090909090909
"4920",2020-08-02,"San Antonio Spurs",108,"Memphis Grizzlies",106,0,0,-2,2,"2019-20",54.0540540540541
"4921",2020-08-02,"Sacramento Kings",116,"Orlando Magic",132,0,1,16,16,"2019-20",48.6486486486487
"4922",2020-08-02,"Milwaukee Bucks",116,"Houston Rockets",120,0,1,4,4,"2019-20",66.6666666666667
"4923",2020-08-02,"Dallas Mavericks",115,"Phoenix Suns",117,0,1,2,2,"2019-20",43.5897435897436
"4924",2020-08-03,"Toronto Raptors",107,"Miami Heat",103,0,0,-4,4,"2019-20",76.0869565217391
"4925",2020-08-03,"Denver Nuggets",121,"Oklahoma City Thunder",113,0,0,-8,8,"2019-20",65
"4926",2020-08-03,"Indiana Pacers",111,"Washington Wizards",100,0,0,-11,11,"2019-20",44.4444444444444
"4927",2020-08-03,"Memphis Grizzlies",99,"New Orleans Pelicans",109,0,1,10,10,"2019-20",41.6666666666667
"4928",2020-08-03,"San Antonio Spurs",130,"Philadelphia 76ers",132,0,1,2,2,"2019-20",83.7837837837838
"4929",2020-08-03,"Los Angeles Lakers",116,"Utah Jazz",108,0,0,-8,8,"2019-20",65.7894736842105
"4930",2020-08-04,"Brooklyn Nets",119,"Milwaukee Bucks",116,0,0,-3,3,"2019-20",78.0487804878049
"4931",2020-08-04,"Dallas Mavericks",114,"Sacramento Kings",110,0,0,-4,4,"2019-20",45.7142857142857
"4932",2020-08-04,"Phoenix Suns",117,"Los Angeles Clippers",115,0,0,-2,2,"2019-20",69.7674418604651
"4933",2020-08-04,"Orlando Magic",109,"Indiana Pacers",120,0,1,11,11,"2019-20",65.7894736842105
"4934",2020-08-04,"Boston Celtics",106,"Miami Heat",112,0,1,6,6,"2019-20",76.0869565217391
"4935",2020-08-04,"Houston Rockets",102,"Portland Trail Blazers",110,0,1,8,8,"2019-20",56.4102564102564
"4936",2020-08-05,"Memphis Grizzlies",115,"Utah Jazz",124,0,1,9,9,"2019-20",65.7894736842105
"4937",2020-08-05,"Denver Nuggets",132,"San Antonio Spurs",126,0,0,-6,6,"2019-20",55.8823529411765
"4938",2020-08-05,"Philadelphia 76ers",107,"Washington Wizards",98,0,0,-9,9,"2019-20",44.4444444444444
"4939",2020-08-05,"Oklahoma City Thunder",105,"Los Angeles Lakers",86,0,0,-19,19,"2019-20",72.3404255319149
"4940",2020-08-05,"Toronto Raptors",109,"Orlando Magic",99,0,0,-10,10,"2019-20",48.6486486486487
"4941",2020-08-05,"Brooklyn Nets",115,"Boston Celtics",149,0,1,34,34,"2019-20",65.9090909090909
"4942",2020-08-06,"New Orleans Pelicans",125,"Sacramento Kings",140,0,1,15,15,"2019-20",45.7142857142857
"4943",2020-08-06,"Miami Heat",116,"Milwaukee Bucks",130,0,1,14,14,"2019-20",78.0487804878049
"4944",2020-08-06,"Indiana Pacers",99,"Phoenix Suns",114,0,1,15,15,"2019-20",43.5897435897436
"4945",2020-08-06,"Los Angeles Clippers",126,"Dallas Mavericks",111,0,0,-15,15,"2019-20",51.219512195122
"4946",2020-08-06,"Portland Trail Blazers",125,"Denver Nuggets",115,0,0,-10,10,"2019-20",67.3913043478261
"4947",2020-08-06,"Los Angeles Lakers",97,"Houston Rockets",113,0,1,16,16,"2019-20",66.6666666666667
"4948",2020-08-07,"Utah Jazz",111,"San Antonio Spurs",119,0,1,8,8,"2019-20",55.8823529411765
"4949",2020-08-07,"Oklahoma City Thunder",92,"Memphis Grizzlies",121,0,1,29,29,"2019-20",54.0540540540541
"4950",2020-08-07,"Sacramento Kings",106,"Brooklyn Nets",119,0,1,13,13,"2019-20",52.6315789473684
"4951",2020-08-07,"Orlando Magic",101,"Philadelphia 76ers",108,0,1,7,7,"2019-20",83.7837837837838
"4952",2020-08-07,"Washington Wizards",107,"New Orleans Pelicans",118,0,1,11,11,"2019-20",41.6666666666667
"4953",2020-08-07,"Boston Celtics",122,"Toronto Raptors",100,0,0,-22,22,"2019-20",66.6666666666667
"4954",2020-08-08,"Los Angeles Clippers",122,"Portland Trail Blazers",117,0,0,-5,5,"2019-20",56.4102564102564
"4955",2020-08-08,"Utah Jazz",132,"Denver Nuggets",134,0,1,2,2,"2019-20",67.3913043478261
"4956",2020-08-08,"Los Angeles Lakers",111,"Indiana Pacers",116,0,1,5,5,"2019-20",65.7894736842105
"4957",2020-08-08,"Phoenix Suns",119,"Miami Heat",112,0,0,-7,7,"2019-20",76.0869565217391
"4958",2020-08-08,"Milwaukee Bucks",132,"Dallas Mavericks",136,0,1,4,4,"2019-20",51.219512195122
"4959",2020-08-09,"Washington Wizards",103,"Oklahoma City Thunder",121,0,1,18,18,"2019-20",65
"4960",2020-08-09,"Memphis Grizzlies",99,"Toronto Raptors",108,0,1,9,9,"2019-20",66.6666666666667
"4961",2020-08-09,"San Antonio Spurs",122,"New Orleans Pelicans",113,0,0,-9,9,"2019-20",41.6666666666667
"4962",2020-08-09,"Orlando Magic",119,"Boston Celtics",122,0,1,3,3,"2019-20",65.9090909090909
"4963",2020-08-09,"Philadelphia 76ers",121,"Portland Trail Blazers",124,0,1,3,3,"2019-20",56.4102564102564
"4964",2020-08-09,"Houston Rockets",129,"Sacramento Kings",112,0,0,-17,17,"2019-20",45.7142857142857
"4965",2020-08-09,"Brooklyn Nets",129,"Los Angeles Clippers",120,0,0,-9,9,"2019-20",69.7674418604651
"4966",2020-08-10,"Oklahoma City Thunder",101,"Phoenix Suns",128,0,1,27,27,"2019-20",43.5897435897436
"4967",2020-08-10,"Dallas Mavericks",122,"Utah Jazz",114,0,0,-8,8,"2019-20",65.7894736842105
"4968",2020-08-10,"Toronto Raptors",114,"Milwaukee Bucks",106,0,0,-8,8,"2019-20",78.0487804878049
"4969",2020-08-10,"Indiana Pacers",92,"Miami Heat",114,0,1,22,22,"2019-20",76.0869565217391
"4970",2020-08-10,"Denver Nuggets",121,"Los Angeles Lakers",124,0,1,3,3,"2019-20",72.3404255319149
"4971",2020-08-11,"Brooklyn Nets",108,"Orlando Magic",96,0,0,-12,12,"2019-20",48.6486486486487
"4972",2020-08-11,"Houston Rockets",105,"San Antonio Spurs",123,0,1,18,18,"2019-20",55.8823529411765
"4973",2020-08-11,"Phoenix Suns",130,"Philadelphia 76ers",117,0,0,-13,13,"2019-20",83.7837837837838
"4974",2020-08-11,"Boston Celtics",122,"Memphis Grizzlies",107,0,0,-15,15,"2019-20",54.0540540540541
"4975",2020-08-11,"Portland Trail Blazers",134,"Dallas Mavericks",131,0,0,-3,3,"2019-20",51.219512195122
"4976",2020-08-11,"New Orleans Pelicans",106,"Sacramento Kings",112,0,1,6,6,"2019-20",45.7142857142857
"4977",2020-08-11,"Milwaukee Bucks",126,"Washington Wizards",113,0,0,-13,13,"2019-20",44.4444444444444
"4978",2020-08-12,"Indiana Pacers",108,"Houston Rockets",104,0,0,-4,4,"2019-20",66.6666666666667
"4979",2020-08-12,"Toronto Raptors",125,"Philadelphia 76ers",121,0,0,-4,4,"2019-20",83.7837837837838
"4980",2020-08-12,"Miami Heat",115,"Oklahoma City Thunder",116,0,1,1,1,"2019-20",65
"4981",2020-08-12,"Los Angeles Clippers",124,"Denver Nuggets",111,0,0,-13,13,"2019-20",67.3913043478261
"4982",2020-08-13,"Washington Wizards",96,"Boston Celtics",90,0,0,-6,6,"2019-20",65.9090909090909
"4983",2020-08-13,"Sacramento Kings",136,"Los Angeles Lakers",122,0,0,-14,14,"2019-20",72.3404255319149
"4984",2020-08-13,"Milwaukee Bucks",106,"Memphis Grizzlies",119,0,1,13,13,"2019-20",54.0540540540541
"4985",2020-08-13,"Dallas Mavericks",102,"Phoenix Suns",128,0,1,26,26,"2019-20",43.5897435897436
"4986",2020-08-13,"San Antonio Spurs",112,"Utah Jazz",118,0,1,6,6,"2019-20",65.7894736842105
"4987",2020-08-13,"Portland Trail Blazers",134,"Brooklyn Nets",133,0,0,-1,1,"2019-20",52.6315789473684
"4988",2020-08-13,"New Orleans Pelicans",127,"Orlando Magic",133,0,1,6,6,"2019-20",48.6486486486487
"4989",2020-08-14,"Denver Nuggets",109,"Toronto Raptors",117,0,1,8,8,"2019-20",66.6666666666667
"4990",2020-08-14,"Miami Heat",92,"Indiana Pacers",109,0,1,17,17,"2019-20",65.7894736842105
"4991",2020-08-14,"Oklahoma City Thunder",103,"Los Angeles Clippers",107,0,1,4,4,"2019-20",69.7674418604651
"4992",2020-08-14,"Philadelphia 76ers",134,"Houston Rockets",96,0,0,-38,38,"2019-20",66.6666666666667
"4993",2020-08-15,"Memphis Grizzlies",122,"Portland Trail Blazers",126,0,1,4,4,"2019-20",56.4102564102564
"4994",2020-08-17,"Utah Jazz",125,"Denver Nuggets",135,0,1,10,10,"2019-20",67.3913043478261
"4995",2020-08-17,"Brooklyn Nets",110,"Toronto Raptors",134,0,1,24,24,"2019-20",66.6666666666667
"4996",2020-08-17,"Philadelphia 76ers",101,"Boston Celtics",109,0,1,8,8,"2019-20",65.9090909090909
"4997",2020-08-17,"Dallas Mavericks",110,"Los Angeles Clippers",118,0,1,8,8,"2019-20",69.7674418604651
"4998",2020-08-18,"Orlando Magic",122,"Milwaukee Bucks",110,0,0,-12,12,"2019-20",78.0487804878049
"4999",2020-08-18,"Miami Heat",113,"Indiana Pacers",101,0,0,-12,12,"2019-20",65.7894736842105
"5000",2020-08-18,"Oklahoma City Thunder",108,"Houston Rockets",123,0,1,15,15,"2019-20",66.6666666666667
"5001",2020-08-18,"Portland Trail Blazers",100,"Los Angeles Lakers",93,0,0,-7,7,"2019-20",72.3404255319149
"5002",2020-08-19,"Brooklyn Nets",99,"Toronto Raptors",104,0,1,5,5,"2019-20",66.6666666666667
"5003",2020-08-19,"Utah Jazz",124,"Denver Nuggets",105,0,0,-19,19,"2019-20",67.3913043478261
"5004",2020-08-19,"Philadelphia 76ers",101,"Boston Celtics",128,0,1,27,27,"2019-20",65.9090909090909
"5005",2020-08-19,"Dallas Mavericks",127,"Los Angeles Clippers",114,0,0,-13,13,"2019-20",69.7674418604651
"5006",2020-08-20,"Miami Heat",109,"Indiana Pacers",100,0,0,-9,9,"2019-20",65.7894736842105
"5007",2020-08-20,"Oklahoma City Thunder",98,"Houston Rockets",111,0,1,13,13,"2019-20",66.6666666666667
"5008",2020-08-20,"Orlando Magic",96,"Milwaukee Bucks",111,0,1,15,15,"2019-20",78.0487804878049
"5009",2020-08-20,"Portland Trail Blazers",88,"Los Angeles Lakers",111,0,1,23,23,"2019-20",72.3404255319149
"5010",2020-08-21,"Toronto Raptors",117,"Brooklyn Nets",92,0,0,-25,25,"2019-20",52.6315789473684
"5011",2020-08-21,"Denver Nuggets",87,"Utah Jazz",124,0,1,37,37,"2019-20",65.7894736842105
"5012",2020-08-21,"Boston Celtics",102,"Philadelphia 76ers",94,0,0,-8,8,"2019-20",83.7837837837838
"5013",2020-08-21,"Los Angeles Clippers",130,"Dallas Mavericks",122,0,0,-8,8,"2019-20",51.219512195122
"5014",2020-08-22,"Milwaukee Bucks",121,"Orlando Magic",107,0,0,-14,14,"2019-20",48.6486486486487
"5015",2020-08-22,"Indiana Pacers",115,"Miami Heat",124,0,1,9,9,"2019-20",76.0869565217391
"5016",2020-08-22,"Houston Rockets",107,"Oklahoma City Thunder",119,0,1,12,12,"2019-20",65
"5017",2020-08-22,"Los Angeles Lakers",116,"Portland Trail Blazers",108,0,0,-8,8,"2019-20",56.4102564102564
"5018",2020-08-23,"Boston Celtics",110,"Philadelphia 76ers",106,0,0,-4,4,"2019-20",83.7837837837838
"5019",2020-08-23,"Los Angeles Clippers",133,"Dallas Mavericks",135,0,1,2,2,"2019-20",51.219512195122
"5020",2020-08-23,"Toronto Raptors",150,"Brooklyn Nets",122,0,0,-28,28,"2019-20",52.6315789473684
"5021",2020-08-23,"Denver Nuggets",127,"Utah Jazz",129,0,1,2,2,"2019-20",65.7894736842105
"5022",2020-08-24,"Milwaukee Bucks",121,"Orlando Magic",106,0,0,-15,15,"2019-20",48.6486486486487
"5023",2020-08-24,"Houston Rockets",114,"Oklahoma City Thunder",117,0,1,3,3,"2019-20",65
"5024",2020-08-24,"Indiana Pacers",87,"Miami Heat",99,0,1,12,12,"2019-20",76.0869565217391
"5025",2020-08-24,"Los Angeles Lakers",135,"Portland Trail Blazers",115,0,0,-20,20,"2019-20",56.4102564102564
"5026",2020-08-25,"Utah Jazz",107,"Denver Nuggets",117,0,1,10,10,"2019-20",67.3913043478261
"5027",2020-08-25,"Dallas Mavericks",111,"Los Angeles Clippers",154,0,1,43,43,"2019-20",69.7674418604651
"5028",2020-08-29,"Orlando Magic",104,"Milwaukee Bucks",118,0,1,14,14,"2019-20",78.0487804878049
"5029",2020-08-29,"Oklahoma City Thunder",80,"Houston Rockets",114,0,1,34,34,"2019-20",66.6666666666667
"5030",2020-08-29,"Portland Trail Blazers",122,"Los Angeles Lakers",131,0,1,9,9,"2019-20",72.3404255319149
"5031",2020-08-30,"Boston Celtics",112,"Toronto Raptors",94,0,0,-18,18,"2019-20",66.6666666666667
"5032",2020-08-30,"Los Angeles Clippers",111,"Dallas Mavericks",97,0,0,-14,14,"2019-20",51.219512195122
"5033",2020-08-30,"Denver Nuggets",119,"Utah Jazz",107,0,0,-12,12,"2019-20",65.7894736842105
"5034",2020-08-31,"Miami Heat",115,"Milwaukee Bucks",104,0,0,-11,11,"2019-20",78.0487804878049
"5035",2020-08-31,"Houston Rockets",100,"Oklahoma City Thunder",104,0,1,4,4,"2019-20",65
"5036",2020-09-01,"Boston Celtics",102,"Toronto Raptors",99,0,0,-3,3,"2019-20",66.6666666666667
"5037",2020-09-01,"Utah Jazz",78,"Denver Nuggets",80,0,1,2,2,"2019-20",67.3913043478261
"5038",2020-09-02,"Miami Heat",116,"Milwaukee Bucks",114,0,0,-2,2,"2019-20",78.0487804878049
"5039",2020-09-02,"Oklahoma City Thunder",102,"Houston Rockets",104,0,1,2,2,"2019-20",66.6666666666667
"5040",2020-09-03,"Toronto Raptors",104,"Boston Celtics",103,0,0,-1,1,"2019-20",65.9090909090909
"5041",2020-09-03,"Denver Nuggets",97,"Los Angeles Clippers",120,0,1,23,23,"2019-20",69.7674418604651
"5042",2020-09-04,"Milwaukee Bucks",100,"Miami Heat",115,0,1,15,15,"2019-20",76.0869565217391
"5043",2020-09-04,"Houston Rockets",112,"Los Angeles Lakers",97,0,0,-15,15,"2019-20",72.3404255319149
"5044",2020-09-05,"Toronto Raptors",100,"Boston Celtics",93,0,0,-7,7,"2019-20",65.9090909090909
"5045",2020-09-05,"Denver Nuggets",110,"Los Angeles Clippers",101,0,0,-9,9,"2019-20",69.7674418604651
"5046",2020-09-06,"Milwaukee Bucks",118,"Miami Heat",115,0,0,-3,3,"2019-20",76.0869565217391
"5047",2020-09-06,"Houston Rockets",109,"Los Angeles Lakers",117,0,1,8,8,"2019-20",72.3404255319149
"5048",2020-09-07,"Boston Celtics",111,"Toronto Raptors",89,0,0,-22,22,"2019-20",66.6666666666667
"5049",2020-09-07,"Los Angeles Clippers",113,"Denver Nuggets",107,0,0,-6,6,"2019-20",67.3913043478261
"5050",2020-09-08,"Miami Heat",103,"Milwaukee Bucks",94,0,0,-9,9,"2019-20",78.0487804878049
"5051",2020-09-08,"Los Angeles Lakers",112,"Houston Rockets",102,0,0,-10,10,"2019-20",66.6666666666667
"5052",2020-09-09,"Toronto Raptors",125,"Boston Celtics",122,0,0,-3,3,"2019-20",65.9090909090909
"5053",2020-09-09,"Los Angeles Clippers",96,"Denver Nuggets",85,0,0,-11,11,"2019-20",67.3913043478261
"5054",2020-09-10,"Los Angeles Lakers",110,"Houston Rockets",100,0,0,-10,10,"2019-20",66.6666666666667
"5055",2020-09-11,"Denver Nuggets",111,"Los Angeles Clippers",105,0,0,-6,6,"2019-20",69.7674418604651
"5056",2020-09-11,"Boston Celtics",92,"Toronto Raptors",87,0,0,-5,5,"2019-20",66.6666666666667
"5057",2020-09-12,"Houston Rockets",96,"Los Angeles Lakers",119,0,1,23,23,"2019-20",72.3404255319149
"5058",2020-09-13,"Los Angeles Clippers",98,"Denver Nuggets",111,0,1,13,13,"2019-20",67.3913043478261
"5059",2020-09-15,"Miami Heat",117,"Boston Celtics",114,0,0,-3,3,"2019-20",65.9090909090909
"5060",2020-09-15,"Denver Nuggets",104,"Los Angeles Clippers",89,0,0,-15,15,"2019-20",69.7674418604651
"5061",2020-09-17,"Miami Heat",106,"Boston Celtics",101,0,0,-5,5,"2019-20",65.9090909090909
"5062",2020-09-18,"Denver Nuggets",114,"Los Angeles Lakers",126,0,1,12,12,"2019-20",72.3404255319149
"5063",2020-09-19,"Boston Celtics",117,"Miami Heat",106,0,0,-11,11,"2019-20",76.0869565217391
"5064",2020-09-20,"Denver Nuggets",103,"Los Angeles Lakers",105,0,1,2,2,"2019-20",72.3404255319149
"5065",2020-09-22,"Los Angeles Lakers",106,"Denver Nuggets",114,0,1,8,8,"2019-20",67.3913043478261
"5066",2020-09-23,"Boston Celtics",109,"Miami Heat",112,0,1,3,3,"2019-20",76.0869565217391
"5067",2020-09-24,"Los Angeles Lakers",114,"Denver Nuggets",108,0,0,-6,6,"2019-20",67.3913043478261
"5068",2020-09-25,"Miami Heat",108,"Boston Celtics",121,0,1,13,13,"2019-20",65.9090909090909
"5069",2020-09-26,"Denver Nuggets",107,"Los Angeles Lakers",117,0,1,10,10,"2019-20",72.3404255319149
"5070",2020-09-27,"Boston Celtics",113,"Miami Heat",125,0,1,12,12,"2019-20",76.0869565217391
"5071",2020-09-30,"Miami Heat",98,"Los Angeles Lakers",116,0,1,18,18,"2019-20",72.3404255319149
"5072",2020-10-02,"Miami Heat",114,"Los Angeles Lakers",124,0,1,10,10,"2019-20",72.3404255319149
"5073",2020-10-04,"Los Angeles Lakers",104,"Miami Heat",115,0,1,11,11,"2019-20",76.0869565217391
"5074",2020-10-06,"Los Angeles Lakers",102,"Miami Heat",96,0,0,-6,6,"2019-20",76.0869565217391
"5075",2020-10-09,"Miami Heat",111,"Los Angeles Lakers",108,0,0,-3,3,"2019-20",72.3404255319149
"5076",2020-10-11,"Los Angeles Lakers",106,"Miami Heat",93,0,0,-13,13,"2019-20",76.0869565217391
"5077",2020-12-22,"Golden State Warriors",99,"Brooklyn Nets",125,0,1,26,26,"2020-21",79.0697674418605
"5078",2020-12-22,"Los Angeles Clippers",116,"Los Angeles Lakers",109,0,0,-7,7,"2020-21",57.5
"5079",2020-12-23,"Charlotte Hornets",114,"Cleveland Cavaliers",121,300,1,7,7,"2020-21",36.1111111111111
"5080",2020-12-23,"New York Knicks",107,"Indiana Pacers",121,0,1,14,14,"2020-21",37.8378378378378
"5081",2020-12-23,"Miami Heat",107,"Orlando Magic",113,3396,1,6,6,"2020-21",30.5555555555556
"5082",2020-12-23,"Washington Wizards",107,"Philadelphia 76ers",113,0,1,6,6,"2020-21",76.7441860465116
"5083",2020-12-23,"New Orleans Pelicans",113,"Toronto Raptors",99,3800,0,-14,14,"2020-21",44.4444444444444
"5084",2020-12-23,"Milwaukee Bucks",121,"Boston Celtics",122,0,1,1,1,"2020-21",58.974358974359
"5085",2020-12-23,"Atlanta Hawks",124,"Chicago Bulls",104,0,0,-20,20,"2020-21",41.6666666666667
"5086",2020-12-23,"San Antonio Spurs",131,"Memphis Grizzlies",119,0,0,-12,12,"2020-21",48.7179487179487
"5087",2020-12-23,"Detroit Pistons",101,"Minnesota Timberwolves",111,0,1,10,10,"2020-21",36.1111111111111
"5088",2020-12-23,"Sacramento Kings",124,"Denver Nuggets",122,0,0,-2,2,"2020-21",65.8536585365854
"5089",2020-12-23,"Utah Jazz",120,"Portland Trail Blazers",100,0,0,-20,20,"2020-21",53.8461538461538
"5090",2020-12-23,"Dallas Mavericks",102,"Phoenix Suns",106,0,1,4,4,"2020-21",74.468085106383
"5091",2020-12-25,"New Orleans Pelicans",98,"Miami Heat",111,0,1,13,13,"2020-21",55.2631578947368
"5092",2020-12-25,"Golden State Warriors",99,"Milwaukee Bucks",138,0,1,39,39,"2020-21",76.5957446808511
"5093",2020-12-25,"Brooklyn Nets",123,"Boston Celtics",95,0,0,-28,28,"2020-21",58.974358974359
"5094",2020-12-25,"Dallas Mavericks",115,"Los Angeles Lakers",138,0,1,23,23,"2020-21",57.5
"5095",2020-12-25,"Los Angeles Clippers",121,"Denver Nuggets",108,0,0,-13,13,"2020-21",65.8536585365854
"5096",2020-12-26,"Atlanta Hawks",122,"Memphis Grizzlies",112,0,0,-10,10,"2020-21",48.7179487179487
"5097",2020-12-26,"Oklahoma City Thunder",109,"Charlotte Hornets",107,0,0,-2,2,"2020-21",50
"5098",2020-12-26,"Cleveland Cavaliers",128,"Detroit Pistons",119,0,0,-9,9,"2020-21",36.1111111111111
"5099",2020-12-26,"Orlando Magic",130,"Washington Wizards",120,0,0,-10,10,"2020-21",53.8461538461538
"5100",2020-12-26,"Philadelphia 76ers",109,"New York Knicks",89,0,0,-20,20,"2020-21",66.6666666666667
"5101",2020-12-26,"Indiana Pacers",125,"Chicago Bulls",106,0,0,-19,19,"2020-21",41.6666666666667
"5102",2020-12-26,"Toronto Raptors",114,"San Antonio Spurs",119,0,1,5,5,"2020-21",38.8888888888889
"5103",2020-12-26,"Minnesota Timberwolves",116,"Utah Jazz",111,1932,0,-5,5,"2020-21",83.3333333333333
"5104",2020-12-26,"Houston Rockets",126,"Portland Trail Blazers",128,0,1,2,2,"2020-21",53.8461538461538
"5105",2020-12-26,"Phoenix Suns",103,"Sacramento Kings",106,0,1,3,3,"2020-21",44.4444444444444
"5106",2020-12-27,"Dallas Mavericks",124,"Los Angeles Clippers",73,0,0,-51,51,"2020-21",67.3913043478261
"5107",2020-12-27,"San Antonio Spurs",95,"New Orleans Pelicans",98,750,1,3,3,"2020-21",50
"5108",2020-12-27,"Orlando Magic",120,"Washington Wizards",113,0,0,-7,7,"2020-21",53.8461538461538
"5109",2020-12-27,"Brooklyn Nets",104,"Charlotte Hornets",106,0,1,2,2,"2020-21",50
"5110",2020-12-27,"Philadelphia 76ers",94,"Cleveland Cavaliers",118,300,1,24,24,"2020-21",36.1111111111111
"5111",2020-12-27,"Milwaukee Bucks",110,"New York Knicks",130,0,1,20,20,"2020-21",66.6666666666667
"5112",2020-12-27,"Boston Celtics",107,"Indiana Pacers",108,0,1,1,1,"2020-21",37.8378378378378
"5113",2020-12-27,"Golden State Warriors",129,"Chicago Bulls",128,0,0,-1,1,"2020-21",41.6666666666667
"5114",2020-12-27,"Phoenix Suns",116,"Sacramento Kings",100,0,0,-16,16,"2020-21",44.4444444444444
"5115",2020-12-27,"Minnesota Timberwolves",91,"Los Angeles Lakers",127,0,1,36,36,"2020-21",57.5
"5116",2020-12-28,"Memphis Grizzlies",116,"Brooklyn Nets",111,0,0,-5,5,"2020-21",79.0697674418605
"5117",2020-12-28,"Detroit Pistons",120,"Atlanta Hawks",128,0,1,8,8,"2020-21",65.9090909090909
"5118",2020-12-28,"Utah Jazz",110,"Oklahoma City Thunder",109,0,0,-1,1,"2020-21",27.7777777777778
"5119",2020-12-28,"Houston Rockets",111,"Denver Nuggets",124,0,1,13,13,"2020-21",65.8536585365854
"5120",2020-12-28,"Portland Trail Blazers",115,"Los Angeles Lakers",107,0,0,-8,8,"2020-21",57.5
"5121",2020-12-29,"New York Knicks",95,"Cleveland Cavaliers",86,300,0,-9,9,"2020-21",36.1111111111111
"5122",2020-12-29,"Golden State Warriors",116,"Detroit Pistons",106,0,0,-10,10,"2020-21",36.1111111111111
"5123",2020-12-29,"Boston Celtics",116,"Indiana Pacers",111,0,0,-5,5,"2020-21",37.8378378378378
"5124",2020-12-29,"Chicago Bulls",115,"Washington Wizards",107,0,0,-8,8,"2020-21",53.8461538461538
"5125",2020-12-29,"Toronto Raptors",93,"Philadelphia 76ers",100,0,1,7,7,"2020-21",76.7441860465116
"5126",2020-12-29,"Milwaukee Bucks",144,"Miami Heat",97,0,0,-47,47,"2020-21",55.2631578947368
"5127",2020-12-29,"Orlando Magic",118,"Oklahoma City Thunder",107,0,0,-11,11,"2020-21",27.7777777777778
"5128",2020-12-29,"New Orleans Pelicans",86,"Phoenix Suns",111,0,1,25,25,"2020-21",74.468085106383
"5129",2020-12-29,"Denver Nuggets",115,"Sacramento Kings",125,0,1,10,10,"2020-21",44.4444444444444
"5130",2020-12-29,"Minnesota Timberwolves",101,"Los Angeles Clippers",124,0,1,23,23,"2020-21",67.3913043478261
"5131",2020-12-30,"Milwaukee Bucks",108,"Miami Heat",119,0,1,11,11,"2020-21",55.2631578947368
"5132",2020-12-30,"Atlanta Hawks",141,"Brooklyn Nets",145,0,1,4,4,"2020-21",79.0697674418605
"5133",2020-12-30,"Memphis Grizzlies",107,"Boston Celtics",126,0,1,19,19,"2020-21",58.974358974359
"5134",2020-12-30,"Charlotte Hornets",118,"Dallas Mavericks",99,0,0,-19,19,"2020-21",53.8461538461538
"5135",2020-12-30,"Los Angeles Lakers",121,"San Antonio Spurs",107,0,0,-14,14,"2020-21",38.8888888888889
"5136",2020-12-30,"Portland Trail Blazers",105,"Los Angeles Clippers",128,0,1,23,23,"2020-21",67.3913043478261
"5137",2020-12-31,"Cleveland Cavaliers",99,"Indiana Pacers",119,0,1,20,20,"2020-21",37.8378378378378
"5138",2020-12-31,"Chicago Bulls",133,"Washington Wizards",130,0,0,-3,3,"2020-21",53.8461538461538
"5139",2020-12-31,"Philadelphia 76ers",116,"Orlando Magic",92,3247,0,-24,24,"2020-21",30.5555555555556
"5140",2020-12-31,"Sacramento Kings",119,"Houston Rockets",122,3247,1,3,3,"2020-21",25
"5141",2020-12-31,"New York Knicks",83,"Toronto Raptors",100,3449,1,17,17,"2020-21",44.4444444444444
"5142",2020-12-31,"New Orleans Pelicans",113,"Oklahoma City Thunder",80,0,0,-33,33,"2020-21",27.7777777777778
"5143",2020-12-31,"Phoenix Suns",106,"Utah Jazz",95,1932,0,-11,11,"2020-21",83.3333333333333
"5144",2021-01-01,"Memphis Grizzlies",108,"Charlotte Hornets",93,0,0,-15,15,"2020-21",50
"5145",2021-01-01,"Miami Heat",83,"Dallas Mavericks",93,0,1,10,10,"2020-21",53.8461538461538
"5146",2021-01-01,"Boston Celtics",93,"Detroit Pistons",96,0,1,3,3,"2020-21",36.1111111111111
"5147",2021-01-01,"Atlanta Hawks",114,"Brooklyn Nets",96,0,0,-18,18,"2020-21",79.0697674418605
"5148",2021-01-01,"Chicago Bulls",96,"Milwaukee Bucks",126,0,1,30,30,"2020-21",76.5957446808511
"5149",2021-01-01,"Washington Wizards",130,"Minnesota Timberwolves",109,0,0,-21,21,"2020-21",36.1111111111111
"5150",2021-01-01,"Los Angeles Lakers",109,"San Antonio Spurs",103,0,0,-6,6,"2020-21",38.8888888888889
"5151",2021-01-01,"Phoenix Suns",106,"Denver Nuggets",103,0,0,-3,3,"2020-21",65.8536585365854
"5152",2021-01-01,"Los Angeles Clippers",100,"Utah Jazz",106,1932,1,6,6,"2020-21",83.3333333333333
"5153",2021-01-01,"Portland Trail Blazers",123,"Golden State Warriors",98,0,0,-25,25,"2020-21",67.5675675675676
"5154",2021-01-02,"Sacramento Kings",94,"Houston Rockets",102,3065,1,8,8,"2020-21",25
"5155",2021-01-02,"New York Knicks",106,"Indiana Pacers",102,0,0,-4,4,"2020-21",37.8378378378378
"5156",2021-01-02,"Oklahoma City Thunder",108,"Orlando Magic",99,3339,0,-9,9,"2020-21",30.5555555555556
"5157",2021-01-02,"Charlotte Hornets",112,"Philadelphia 76ers",127,0,1,15,15,"2020-21",76.7441860465116
"5158",2021-01-02,"Cleveland Cavaliers",96,"Atlanta Hawks",91,0,0,-5,5,"2020-21",65.9090909090909
"5159",2021-01-02,"Toronto Raptors",116,"New Orleans Pelicans",120,750,1,4,4,"2020-21",50
"5160",2021-01-03,"Boston Celtics",122,"Detroit Pistons",120,0,0,-2,2,"2020-21",36.1111111111111
"5161",2021-01-03,"Washington Wizards",123,"Brooklyn Nets",122,0,0,-1,1,"2020-21",79.0697674418605
"5162",2021-01-03,"Los Angeles Lakers",108,"Memphis Grizzlies",94,0,0,-14,14,"2020-21",48.7179487179487
"5163",2021-01-03,"Denver Nuggets",124,"Minnesota Timberwolves",109,0,0,-15,15,"2020-21",36.1111111111111
"5164",2021-01-03,"Utah Jazz",130,"San Antonio Spurs",109,0,0,-21,21,"2020-21",38.8888888888889
"5165",2021-01-03,"Dallas Mavericks",108,"Chicago Bulls",118,0,1,10,10,"2020-21",41.6666666666667
"5166",2021-01-03,"Los Angeles Clippers",112,"Phoenix Suns",107,0,0,-5,5,"2020-21",74.468085106383
"5167",2021-01-03,"Portland Trail Blazers",122,"Golden State Warriors",137,0,1,15,15,"2020-21",67.5675675675676
"5168",2021-01-04,"Cleveland Cavaliers",83,"Orlando Magic",103,2726,1,20,20,"2020-21",30.5555555555556
"5169",2021-01-04,"Charlotte Hornets",101,"Philadelphia 76ers",118,0,1,17,17,"2020-21",76.7441860465116
"5170",2021-01-04,"New York Knicks",113,"Atlanta Hawks",108,0,0,-5,5,"2020-21",65.9090909090909
"5171",2021-01-04,"Oklahoma City Thunder",90,"Miami Heat",118,0,1,28,28,"2020-21",55.2631578947368
"5172",2021-01-04,"Boston Celtics",126,"Toronto Raptors",114,3740,0,-12,12,"2020-21",44.4444444444444
"5173",2021-01-04,"Dallas Mavericks",113,"Houston Rockets",100,3070,0,-13,13,"2020-21",25
"5174",2021-01-04,"Detroit Pistons",115,"Milwaukee Bucks",125,0,1,10,10,"2020-21",76.5957446808511
"5175",2021-01-04,"Indiana Pacers",118,"New Orleans Pelicans",116,750,0,-2,2,"2020-21",50
"5176",2021-01-04,"Sacramento Kings",106,"Golden State Warriors",137,0,1,31,31,"2020-21",67.5675675675676
"5177",2021-01-05,"Utah Jazz",96,"Brooklyn Nets",130,0,1,34,34,"2020-21",79.0697674418605
"5178",2021-01-05,"Los Angeles Lakers",94,"Memphis Grizzlies",92,0,0,-2,2,"2020-21",48.7179487179487
"5179",2021-01-05,"Minnesota Timberwolves",116,"Denver Nuggets",123,0,1,7,7,"2020-21",65.8536585365854
"5180",2021-01-05,"San Antonio Spurs",116,"Los Angeles Clippers",113,0,0,-3,3,"2020-21",67.3913043478261
"5181",2021-01-05,"Chicago Bulls",111,"Portland Trail Blazers",108,0,0,-3,3,"2020-21",53.8461538461538
"5182",2021-01-06,"Houston Rockets",107,"Indiana Pacers",114,0,1,7,7,"2020-21",37.8378378378378
"5183",2021-01-06,"Cleveland Cavaliers",94,"Orlando Magic",105,2948,1,11,11,"2020-21",30.5555555555556
"5184",2021-01-06,"Washington Wizards",136,"Philadelphia 76ers",141,0,1,5,5,"2020-21",76.7441860465116
"5185",2021-01-06,"Charlotte Hornets",102,"Atlanta Hawks",94,0,0,-8,8,"2020-21",65.9090909090909
"5186",2021-01-06,"Boston Celtics",107,"Miami Heat",105,0,0,-2,2,"2020-21",55.2631578947368
"5187",2021-01-06,"Utah Jazz",100,"New York Knicks",112,0,1,12,12,"2020-21",66.6666666666667
"5188",2021-01-06,"Detroit Pistons",115,"Milwaukee Bucks",130,0,1,15,15,"2020-21",76.5957446808511
"5189",2021-01-06,"Oklahoma City Thunder",111,"New Orleans Pelicans",110,750,0,-1,1,"2020-21",50
"5190",2021-01-06,"Toronto Raptors",115,"Phoenix Suns",123,0,1,8,8,"2020-21",74.468085106383
"5191",2021-01-06,"Los Angeles Clippers",108,"Golden State Warriors",101,0,0,-7,7,"2020-21",67.5675675675676
"5192",2021-01-06,"Chicago Bulls",124,"Sacramento Kings",128,0,1,4,4,"2020-21",44.4444444444444
"5193",2021-01-07,"Philadelphia 76ers",109,"Brooklyn Nets",122,0,1,13,13,"2020-21",79.0697674418605
"5194",2021-01-07,"Cleveland Cavaliers",94,"Memphis Grizzlies",90,0,0,-4,4,"2020-21",48.7179487179487
"5195",2021-01-07,"Dallas Mavericks",124,"Denver Nuggets",117,0,0,-7,7,"2020-21",65.8536585365854
"5196",2021-01-07,"San Antonio Spurs",118,"Los Angeles Lakers",109,0,0,-9,9,"2020-21",57.5
"5197",2021-01-07,"Minnesota Timberwolves",117,"Portland Trail Blazers",135,0,1,18,18,"2020-21",53.8461538461538
"5198",2021-01-08,"Phoenix Suns",105,"Detroit Pistons",110,0,1,5,5,"2020-21",36.1111111111111
"5199",2021-01-08,"Washington Wizards",107,"Boston Celtics",116,0,1,9,9,"2020-21",58.974358974359
"5200",2021-01-08,"Charlotte Hornets",118,"New Orleans Pelicans",110,750,0,-8,8,"2020-21",50
"5201",2021-01-08,"Oklahoma City Thunder",101,"New York Knicks",89,0,0,-12,12,"2020-21",66.6666666666667
"5202",2021-01-08,"Orlando Magic",90,"Houston Rockets",132,3039,1,42,42,"2020-21",25
"5203",2021-01-08,"Brooklyn Nets",110,"Memphis Grizzlies",115,0,1,5,5,"2020-21",48.7179487179487
"5204",2021-01-08,"Utah Jazz",131,"Milwaukee Bucks",118,0,0,-13,13,"2020-21",76.5957446808511
"5205",2021-01-08,"Los Angeles Clippers",105,"Golden State Warriors",115,0,1,10,10,"2020-21",67.5675675675676
"5206",2021-01-08,"Chicago Bulls",115,"Los Angeles Lakers",117,0,1,2,2,"2020-21",57.5
"5207",2021-01-08,"Toronto Raptors",144,"Sacramento Kings",123,0,0,-21,21,"2020-21",44.4444444444444
"5208",2021-01-09,"Denver Nuggets",115,"Philadelphia 76ers",103,0,0,-12,12,"2020-21",76.7441860465116
"5209",2021-01-09,"Atlanta Hawks",105,"Charlotte Hornets",113,0,1,8,8,"2020-21",50
"5210",2021-01-09,"Phoenix Suns",125,"Indiana Pacers",117,0,0,-8,8,"2020-21",37.8378378378378
"5211",2021-01-09,"Miami Heat",128,"Washington Wizards",124,0,0,-4,4,"2020-21",53.8461538461538
"5212",2021-01-09,"Cleveland Cavaliers",90,"Milwaukee Bucks",100,0,1,10,10,"2020-21",76.5957446808511
"5213",2021-01-09,"San Antonio Spurs",125,"Minnesota Timberwolves",122,0,0,-3,3,"2020-21",36.1111111111111
"5214",2021-01-09,"Orlando Magic",98,"Dallas Mavericks",112,0,1,14,14,"2020-21",53.8461538461538
"5215",2021-01-09,"Portland Trail Blazers",125,"Sacramento Kings",99,0,0,-26,26,"2020-21",44.4444444444444
"5216",2021-01-10,"Utah Jazz",96,"Detroit Pistons",86,0,0,-10,10,"2020-21",36.1111111111111
"5217",2021-01-10,"Chicago Bulls",127,"Los Angeles Clippers",130,0,1,3,3,"2020-21",67.3913043478261
"5218",2021-01-10,"Oklahoma City Thunder",129,"Brooklyn Nets",116,0,0,-13,13,"2020-21",79.0697674418605
"5219",2021-01-10,"Denver Nuggets",114,"New York Knicks",89,0,0,-25,25,"2020-21",66.6666666666667
"5220",2021-01-10,"Los Angeles Lakers",120,"Houston Rockets",102,3327,0,-18,18,"2020-21",25
"5221",2021-01-10,"San Antonio Spurs",88,"Minnesota Timberwolves",96,0,1,8,8,"2020-21",36.1111111111111
"5222",2021-01-10,"Toronto Raptors",105,"Golden State Warriors",106,0,1,1,1,"2020-21",67.5675675675676
"5223",2021-01-11,"New York Knicks",88,"Charlotte Hornets",109,0,1,21,21,"2020-21",50
"5224",2021-01-11,"Memphis Grizzlies",101,"Cleveland Cavaliers",91,1944,0,-10,10,"2020-21",36.1111111111111
"5225",2021-01-11,"Milwaukee Bucks",121,"Orlando Magic",99,3248,0,-22,22,"2020-21",30.5555555555556
"5226",2021-01-11,"Phoenix Suns",107,"Washington Wizards",128,0,1,21,21,"2020-21",53.8461538461538
"5227",2021-01-11,"Philadelphia 76ers",94,"Atlanta Hawks",112,0,1,18,18,"2020-21",65.9090909090909
"5228",2021-01-11,"Toronto Raptors",111,"Portland Trail Blazers",112,0,1,1,1,"2020-21",53.8461538461538
"5229",2021-01-11,"Indiana Pacers",122,"Sacramento Kings",127,0,1,5,5,"2020-21",44.4444444444444
"5230",2021-01-12,"Miami Heat",134,"Philadelphia 76ers",137,0,1,3,3,"2020-21",76.7441860465116
"5231",2021-01-12,"Denver Nuggets",116,"Brooklyn Nets",122,0,1,6,6,"2020-21",79.0697674418605
"5232",2021-01-12,"Utah Jazz",117,"Cleveland Cavaliers",87,1944,0,-30,30,"2020-21",36.1111111111111
"5233",2021-01-12,"Los Angeles Lakers",117,"Houston Rockets",100,3221,0,-17,17,"2020-21",25
"5234",2021-01-12,"San Antonio Spurs",112,"Oklahoma City Thunder",102,0,0,-10,10,"2020-21",27.7777777777778
"5235",2021-01-12,"Indiana Pacers",104,"Golden State Warriors",95,0,0,-9,9,"2020-21",67.5675675675676
"5236",2021-01-13,"Dallas Mavericks",104,"Charlotte Hornets",93,0,0,-11,11,"2020-21",50
"5237",2021-01-13,"Milwaukee Bucks",110,"Detroit Pistons",101,0,0,-9,9,"2020-21",36.1111111111111
"5238",2021-01-13,"Brooklyn Nets",116,"New York Knicks",109,0,0,-7,7,"2020-21",66.6666666666667
"5239",2021-01-13,"Memphis Grizzlies",118,"Minnesota Timberwolves",107,0,0,-11,11,"2020-21",36.1111111111111
"5240",2021-01-13,"Los Angeles Lakers",128,"Oklahoma City Thunder",99,0,0,-29,29,"2020-21",27.7777777777778
"5241",2021-01-13,"New Orleans Pelicans",106,"Los Angeles Clippers",111,0,1,5,5,"2020-21",67.3913043478261
"5242",2021-01-13,"Portland Trail Blazers",132,"Sacramento Kings",126,0,0,-6,6,"2020-21",44.4444444444444
"5243",2021-01-14,"Miami Heat",108,"Philadelphia 76ers",125,0,1,17,17,"2020-21",76.7441860465116
"5244",2021-01-14,"Houston Rockets",109,"San Antonio Spurs",105,0,0,-4,4,"2020-21",38.8888888888889
"5245",2021-01-14,"Charlotte Hornets",108,"Toronto Raptors",111,0,1,3,3,"2020-21",44.4444444444444
"5246",2021-01-14,"Golden State Warriors",104,"Denver Nuggets",114,0,1,10,10,"2020-21",65.8536585365854
"5247",2021-01-14,"Indiana Pacers",111,"Portland Trail Blazers",87,0,0,-24,24,"2020-21",53.8461538461538
"5248",2021-01-15,"Orlando Magic",97,"Boston Celtics",124,0,1,27,27,"2020-21",58.974358974359
"5249",2021-01-15,"New York Knicks",103,"Cleveland Cavaliers",106,1944,1,3,3,"2020-21",36.1111111111111
"5250",2021-01-15,"Dallas Mavericks",109,"Milwaukee Bucks",112,0,1,3,3,"2020-21",76.5957446808511
"5251",2021-01-15,"Chicago Bulls",125,"Oklahoma City Thunder",127,0,1,2,2,"2020-21",27.7777777777778
"5252",2021-01-15,"Atlanta Hawks",92,"Utah Jazz",116,1932,1,24,24,"2020-21",83.3333333333333
"5253",2021-01-15,"New Orleans Pelicans",95,"Los Angeles Lakers",112,0,1,17,17,"2020-21",57.5
"5254",2021-01-15,"Los Angeles Clippers",138,"Sacramento Kings",100,0,0,-38,38,"2020-21",44.4444444444444
"5255",2021-01-16,"Houston Rockets",91,"San Antonio Spurs",103,0,1,12,12,"2020-21",38.8888888888889
"5256",2021-01-16,"Orlando Magic",115,"Brooklyn Nets",122,0,1,7,7,"2020-21",79.0697674418605
"5257",2021-01-16,"Charlotte Hornets",113,"Toronto Raptors",116,0,1,3,3,"2020-21",44.4444444444444
"5258",2021-01-16,"Philadelphia 76ers",104,"Memphis Grizzlies",106,206,1,2,2,"2020-21",48.7179487179487
"5259",2021-01-16,"Detroit Pistons",120,"Miami Heat",100,0,0,-20,20,"2020-21",55.2631578947368
"5260",2021-01-16,"Atlanta Hawks",106,"Portland Trail Blazers",112,0,1,6,6,"2020-21",53.8461538461538
"5261",2021-01-17,"New York Knicks",105,"Boston Celtics",75,0,0,-30,30,"2020-21",58.974358974359
"5262",2021-01-17,"Chicago Bulls",117,"Dallas Mavericks",101,0,0,-16,16,"2020-21",53.8461538461538
"5263",2021-01-17,"Utah Jazz",109,"Denver Nuggets",105,0,0,-4,4,"2020-21",65.8536585365854
"5264",2021-01-17,"New Orleans Pelicans",128,"Sacramento Kings",123,0,0,-5,5,"2020-21",44.4444444444444
"5265",2021-01-17,"Indiana Pacers",96,"Los Angeles Clippers",129,0,1,33,33,"2020-21",67.3913043478261
"5266",2021-01-18,"Orlando Magic",84,"New York Knicks",91,0,1,7,7,"2020-21",66.6666666666667
"5267",2021-01-18,"Minnesota Timberwolves",97,"Atlanta Hawks",108,0,1,11,11,"2020-21",65.9090909090909
"5268",2021-01-18,"San Antonio Spurs",125,"Portland Trail Blazers",104,0,0,-21,21,"2020-21",53.8461538461538
"5269",2021-01-18,"Phoenix Suns",104,"Memphis Grizzlies",108,204,1,4,4,"2020-21",48.7179487179487
"5270",2021-01-18,"Milwaukee Bucks",123,"Brooklyn Nets",125,0,1,2,2,"2020-21",79.0697674418605
"5271",2021-01-18,"Dallas Mavericks",93,"Toronto Raptors",116,0,1,23,23,"2020-21",44.4444444444444
"5272",2021-01-18,"Houston Rockets",120,"Chicago Bulls",125,0,1,5,5,"2020-21",41.6666666666667
"5273",2021-01-18,"Detroit Pistons",107,"Miami Heat",113,0,1,6,6,"2020-21",55.2631578947368
"5274",2021-01-18,"Golden State Warriors",115,"Los Angeles Lakers",113,0,0,-2,2,"2020-21",57.5
"5275",2021-01-19,"Oklahoma City Thunder",101,"Denver Nuggets",119,0,1,18,18,"2020-21",65.8536585365854
"5276",2021-01-19,"New Orleans Pelicans",102,"Utah Jazz",118,1932,1,16,16,"2020-21",83.3333333333333
"5277",2021-01-20,"Brooklyn Nets",135,"Cleveland Cavaliers",147,1944,1,12,12,"2020-21",36.1111111111111
"5278",2021-01-20,"Dallas Mavericks",124,"Indiana Pacers",112,0,0,-12,12,"2020-21",37.8378378378378
"5279",2021-01-20,"Boston Celtics",109,"Philadelphia 76ers",117,0,1,8,8,"2020-21",76.7441860465116
"5280",2021-01-20,"Detroit Pistons",115,"Atlanta Hawks",123,0,1,8,8,"2020-21",65.9090909090909
"5281",2021-01-20,"Miami Heat",111,"Toronto Raptors",102,0,0,-9,9,"2020-21",44.4444444444444
"5282",2021-01-20,"Orlando Magic",97,"Minnesota Timberwolves",96,0,0,-1,1,"2020-21",36.1111111111111
"5283",2021-01-20,"Phoenix Suns",109,"Houston Rockets",103,3022,0,-6,6,"2020-21",25
"5284",2021-01-20,"San Antonio Spurs",99,"Golden State Warriors",121,0,1,22,22,"2020-21",67.5675675675676
"5285",2021-01-20,"Sacramento Kings",96,"Los Angeles Clippers",115,0,1,19,19,"2020-21",67.3913043478261
"5286",2021-01-21,"Los Angeles Lakers",113,"Milwaukee Bucks",106,0,0,-7,7,"2020-21",76.5957446808511
"5287",2021-01-21,"New York Knicks",119,"Golden State Warriors",104,0,0,-15,15,"2020-21",67.5675675675676
"5288",2021-01-21,"New Orleans Pelicans",118,"Utah Jazz",129,1932,1,11,11,"2020-21",83.3333333333333
"5289",2021-01-22,"Chicago Bulls",123,"Charlotte Hornets",110,0,0,-13,13,"2020-21",50
"5290",2021-01-22,"Houston Rockets",103,"Detroit Pistons",102,0,0,-1,1,"2020-21",36.1111111111111
"5291",2021-01-22,"Orlando Magic",118,"Indiana Pacers",120,0,1,2,2,"2020-21",37.8378378378378
"5292",2021-01-22,"Brooklyn Nets",113,"Cleveland Cavaliers",125,1944,1,12,12,"2020-21",36.1111111111111
"5293",2021-01-22,"Boston Celtics",110,"Philadelphia 76ers",122,0,1,12,12,"2020-21",76.7441860465116
"5294",2021-01-22,"Miami Heat",81,"Toronto Raptors",101,0,1,20,20,"2020-21",44.4444444444444
"5295",2021-01-22,"Atlanta Hawks",116,"Minnesota Timberwolves",98,0,0,-18,18,"2020-21",36.1111111111111
"5296",2021-01-22,"Dallas Mavericks",122,"San Antonio Spurs",117,0,0,-5,5,"2020-21",38.8888888888889
"5297",2021-01-22,"Oklahoma City Thunder",106,"Los Angeles Clippers",120,0,1,14,14,"2020-21",67.3913043478261
"5298",2021-01-22,"Denver Nuggets",130,"Phoenix Suns",126,0,0,-4,4,"2020-21",74.468085106383
"5299",2021-01-22,"New York Knicks",94,"Sacramento Kings",103,0,1,9,9,"2020-21",44.4444444444444
"5300",2021-01-23,"Miami Heat",124,"Brooklyn Nets",128,0,1,4,4,"2020-21",79.0697674418605
"5301",2021-01-23,"Philadelphia 76ers",114,"Detroit Pistons",110,0,0,-4,4,"2020-21",36.1111111111111
"5302",2021-01-23,"New Orleans Pelicans",110,"Minnesota Timberwolves",120,0,1,10,10,"2020-21",36.1111111111111
"5303",2021-01-23,"Los Angeles Lakers",101,"Chicago Bulls",90,0,0,-11,11,"2020-21",41.6666666666667
"5304",2021-01-23,"Houston Rockets",133,"Dallas Mavericks",108,0,0,-25,25,"2020-21",53.8461538461538
"5305",2021-01-23,"Denver Nuggets",120,"Phoenix Suns",112,0,0,-8,8,"2020-21",74.468085106383
"5306",2021-01-23,"Golden State Warriors",108,"Utah Jazz",127,1932,1,19,19,"2020-21",83.3333333333333
"5307",2021-01-24,"Toronto Raptors",107,"Indiana Pacers",102,0,0,-5,5,"2020-21",37.8378378378378
"5308",2021-01-24,"Oklahoma City Thunder",100,"Los Angeles Clippers",108,0,1,8,8,"2020-21",67.3913043478261
"5309",2021-01-24,"Cleveland Cavaliers",103,"Boston Celtics",141,0,1,38,38,"2020-21",58.974358974359
"5310",2021-01-24,"Charlotte Hornets",107,"Orlando Magic",104,3507,0,-3,3,"2020-21",30.5555555555556
"5311",2021-01-24,"Atlanta Hawks",115,"Milwaukee Bucks",129,0,1,14,14,"2020-21",76.5957446808511
"5312",2021-01-24,"Washington Wizards",101,"San Antonio Spurs",121,0,1,20,20,"2020-21",38.8888888888889
"5313",2021-01-24,"New York Knicks",113,"Portland Trail Blazers",116,0,1,3,3,"2020-21",53.8461538461538
"5314",2021-01-25,"Philadelphia 76ers",104,"Detroit Pistons",119,0,1,15,15,"2020-21",36.1111111111111
"5315",2021-01-25,"Toronto Raptors",114,"Indiana Pacers",129,0,1,15,15,"2020-21",37.8378378378378
"5316",2021-01-25,"Charlotte Hornets",108,"Orlando Magic",117,3167,1,9,9,"2020-21",30.5555555555556
"5317",2021-01-25,"Miami Heat",85,"Brooklyn Nets",98,0,1,13,13,"2020-21",79.0697674418605
"5318",2021-01-25,"Los Angeles Lakers",115,"Cleveland Cavaliers",108,0,0,-7,7,"2020-21",36.1111111111111
"5319",2021-01-25,"Denver Nuggets",117,"Dallas Mavericks",113,0,0,-4,4,"2020-21",53.8461538461538
"5320",2021-01-25,"Boston Celtics",119,"Chicago Bulls",103,0,0,-16,16,"2020-21",41.6666666666667
"5321",2021-01-25,"Minnesota Timberwolves",108,"Golden State Warriors",130,0,1,22,22,"2020-21",67.5675675675676
"5322",2021-01-25,"Oklahoma City Thunder",125,"Portland Trail Blazers",122,0,0,-3,3,"2020-21",53.8461538461538
"5323",2021-01-26,"Los Angeles Clippers",99,"Atlanta Hawks",108,1180,1,9,9,"2020-21",65.9090909090909
"5324",2021-01-26,"Washington Wizards",88,"Houston Rockets",107,2996,1,19,19,"2020-21",25
"5325",2021-01-26,"New York Knicks",94,"Utah Jazz",108,1932,1,14,14,"2020-21",83.3333333333333
"5326",2021-01-27,"Indiana Pacers",116,"Charlotte Hornets",106,0,0,-10,10,"2020-21",50
"5327",2021-01-27,"Detroit Pistons",107,"Cleveland Cavaliers",122,1944,1,15,15,"2020-21",36.1111111111111
"5328",2021-01-27,"Sacramento Kings",121,"Orlando Magic",107,3216,0,-14,14,"2020-21",30.5555555555556
"5329",2021-01-27,"Brooklyn Nets",132,"Atlanta Hawks",128,1008,0,-4,4,"2020-21",65.9090909090909
"5330",2021-01-27,"Denver Nuggets",109,"Miami Heat",82,0,0,-27,27,"2020-21",55.2631578947368
"5331",2021-01-27,"Los Angeles Lakers",106,"Philadelphia 76ers",107,0,1,1,1,"2020-21",76.7441860465116
"5332",2021-01-27,"Milwaukee Bucks",115,"Toronto Raptors",108,0,0,-7,7,"2020-21",44.4444444444444
"5333",2021-01-27,"Boston Celtics",106,"San Antonio Spurs",110,0,1,4,4,"2020-21",38.8888888888889
"5334",2021-01-27,"Washington Wizards",106,"New Orleans Pelicans",124,750,1,18,18,"2020-21",50
"5335",2021-01-27,"Oklahoma City Thunder",102,"Phoenix Suns",97,0,0,-5,5,"2020-21",74.468085106383
"5336",2021-01-27,"Dallas Mavericks",104,"Utah Jazz",116,0,1,12,12,"2020-21",83.3333333333333
"5337",2021-01-27,"Minnesota Timberwolves",111,"Golden State Warriors",123,0,1,12,12,"2020-21",67.5675675675676
"5338",2021-01-28,"Portland Trail Blazers",101,"Houston Rockets",104,3154,1,3,3,"2020-21",25
"5339",2021-01-28,"Los Angeles Lakers",92,"Detroit Pistons",107,0,1,15,15,"2020-21",36.1111111111111
"5340",2021-01-28,"Los Angeles Clippers",109,"Miami Heat",105,0,0,-4,4,"2020-21",55.2631578947368
"5341",2021-01-28,"Golden State Warriors",93,"Phoenix Suns",114,0,1,21,21,"2020-21",74.468085106383
"5342",2021-01-29,"Indiana Pacers",105,"Charlotte Hornets",108,0,1,3,3,"2020-21",50
"5343",2021-01-29,"Atlanta Hawks",116,"Washington Wizards",100,0,0,-16,16,"2020-21",53.8461538461538
"5344",2021-01-29,"Milwaukee Bucks",126,"New Orleans Pelicans",131,1440,1,5,5,"2020-21",50
"5345",2021-01-29,"Cleveland Cavaliers",81,"New York Knicks",102,0,1,21,21,"2020-21",66.6666666666667
"5346",2021-01-29,"Sacramento Kings",126,"Toronto Raptors",124,0,0,-2,2,"2020-21",44.4444444444444
"5347",2021-01-29,"Philadelphia 76ers",118,"Minnesota Timberwolves",94,0,0,-24,24,"2020-21",36.1111111111111
"5348",2021-01-29,"Brooklyn Nets",147,"Oklahoma City Thunder",125,0,0,-22,22,"2020-21",27.7777777777778
"5349",2021-01-29,"Los Angeles Clippers",116,"Orlando Magic",90,3763,0,-26,26,"2020-21",30.5555555555556
"5350",2021-01-29,"Denver Nuggets",109,"San Antonio Spurs",119,0,1,10,10,"2020-21",38.8888888888889
"5351",2021-01-29,"Dallas Mavericks",101,"Utah Jazz",120,1932,1,19,19,"2020-21",83.3333333333333
"5352",2021-01-30,"Portland Trail Blazers",123,"Chicago Bulls",122,0,0,-1,1,"2020-21",41.6666666666667
"5353",2021-01-30,"Milwaukee Bucks",114,"Charlotte Hornets",126,0,1,12,12,"2020-21",50
"5354",2021-01-30,"Sacramento Kings",104,"Miami Heat",105,0,1,1,1,"2020-21",55.2631578947368
"5355",2021-01-30,"Houston Rockets",126,"New Orleans Pelicans",112,1440,0,-14,14,"2020-21",50
"5356",2021-01-30,"Los Angeles Lakers",96,"Boston Celtics",95,0,0,-1,1,"2020-21",58.974358974359
"5357",2021-01-30,"Memphis Grizzlies",129,"San Antonio Spurs",112,0,0,-17,17,"2020-21",38.8888888888889
"5358",2021-01-30,"Phoenix Suns",111,"Dallas Mavericks",105,0,0,-6,6,"2020-21",53.8461538461538
"5359",2021-01-30,"Detroit Pistons",91,"Golden State Warriors",118,0,1,27,27,"2020-21",67.5675675675676
"5360",2021-01-31,"Los Angeles Clippers",129,"New York Knicks",115,0,0,-14,14,"2020-21",66.6666666666667
"5361",2021-01-31,"Utah Jazz",117,"Denver Nuggets",128,0,1,11,11,"2020-21",65.8536585365854
"5362",2021-01-31,"Philadelphia 76ers",119,"Indiana Pacers",110,0,0,-9,9,"2020-21",37.8378378378378
"5363",2021-01-31,"Orlando Magic",102,"Toronto Raptors",115,0,1,13,13,"2020-21",44.4444444444444
"5364",2021-01-31,"Brooklyn Nets",146,"Washington Wizards",149,0,1,3,3,"2020-21",53.8461538461538
"5365",2021-01-31,"Cleveland Cavaliers",104,"Minnesota Timberwolves",109,0,1,5,5,"2020-21",36.1111111111111
"5366",2021-02-01,"Los Angeles Lakers",107,"Atlanta Hawks",99,1341,0,-8,8,"2020-21",65.9090909090909
"5367",2021-02-01,"Charlotte Hornets",129,"Miami Heat",121,0,0,-8,8,"2020-21",55.2631578947368
"5368",2021-02-01,"New York Knicks",102,"Chicago Bulls",110,0,1,8,8,"2020-21",41.6666666666667
"5369",2021-02-01,"Minnesota Timberwolves",98,"Cleveland Cavaliers",100,0,1,2,2,"2020-21",36.1111111111111
"5370",2021-02-01,"Portland Trail Blazers",106,"Milwaukee Bucks",134,0,1,28,28,"2020-21",76.5957446808511
"5371",2021-02-01,"Sacramento Kings",118,"New Orleans Pelicans",109,1440,0,-9,9,"2020-21",50
"5372",2021-02-01,"Houston Rockets",136,"Oklahoma City Thunder",106,0,0,-30,30,"2020-21",27.7777777777778
"5373",2021-02-01,"Phoenix Suns",109,"Dallas Mavericks",108,0,0,-1,1,"2020-21",53.8461538461538
"5374",2021-02-01,"Memphis Grizzlies",133,"San Antonio Spurs",102,0,0,-31,31,"2020-21",38.8888888888889
"5375",2021-02-02,"Toronto Raptors",123,"Orlando Magic",108,3211,0,-15,15,"2020-21",30.5555555555556
"5376",2021-02-02,"Los Angeles Clippers",120,"Brooklyn Nets",124,0,1,4,4,"2020-21",79.0697674418605
"5377",2021-02-02,"Memphis Grizzlies",116,"Indiana Pacers",134,0,1,18,18,"2020-21",37.8378378378378
"5378",2021-02-02,"Portland Trail Blazers",132,"Washington Wizards",121,0,0,-11,11,"2020-21",53.8461538461538
"5379",2021-02-02,"Boston Celtics",111,"Golden State Warriors",107,0,0,-4,4,"2020-21",67.5675675675676
"5380",2021-02-02,"Detroit Pistons",105,"Utah Jazz",117,3902,1,12,12,"2020-21",83.3333333333333
"5381",2021-02-03,"Philadelphia 76ers",118,"Charlotte Hornets",111,0,0,-7,7,"2020-21",50
"5382",2021-02-03,"Indiana Pacers",110,"Milwaukee Bucks",130,0,1,20,20,"2020-21",76.5957446808511
"5383",2021-02-03,"Dallas Mavericks",122,"Atlanta Hawks",116,1259,0,-6,6,"2020-21",65.9090909090909
"5384",2021-02-03,"New York Knicks",107,"Chicago Bulls",103,0,0,-4,4,"2020-21",41.6666666666667
"5385",2021-02-03,"Los Angeles Clippers",121,"Cleveland Cavaliers",99,1944,0,-22,22,"2020-21",36.1111111111111
"5386",2021-02-03,"Washington Wizards",103,"Miami Heat",100,0,0,-3,3,"2020-21",55.2631578947368
"5387",2021-02-03,"Houston Rockets",87,"Oklahoma City Thunder",104,0,1,17,17,"2020-21",27.7777777777778
"5388",2021-02-03,"Minnesota Timberwolves",108,"San Antonio Spurs",111,0,1,3,3,"2020-21",38.8888888888889
"5389",2021-02-03,"Phoenix Suns",101,"New Orleans Pelicans",123,1440,1,22,22,"2020-21",50
"5390",2021-02-03,"Boston Celtics",111,"Sacramento Kings",116,0,1,5,5,"2020-21",44.4444444444444
"5391",2021-02-04,"Utah Jazz",112,"Atlanta Hawks",91,1261,0,-21,21,"2020-21",65.9090909090909
"5392",2021-02-04,"Golden State Warriors",147,"Dallas Mavericks",116,0,0,-31,31,"2020-21",53.8461538461538
"5393",2021-02-04,"Portland Trail Blazers",121,"Philadelphia 76ers",105,0,0,-16,16,"2020-21",76.7441860465116
"5394",2021-02-04,"Houston Rockets",115,"Memphis Grizzlies",103,1762,0,-12,12,"2020-21",48.7179487179487
"5395",2021-02-04,"Denver Nuggets",93,"Los Angeles Lakers",114,0,1,21,21,"2020-21",57.5
"5396",2021-02-05,"New Orleans Pelicans",114,"Indiana Pacers",113,0,0,-1,1,"2020-21",37.8378378378378
"5397",2021-02-05,"Chicago Bulls",119,"Orlando Magic",123,3535,1,4,4,"2020-21",30.5555555555556
"5398",2021-02-05,"Toronto Raptors",123,"Brooklyn Nets",117,0,0,-6,6,"2020-21",79.0697674418605
"5399",2021-02-05,"Milwaukee Bucks",123,"Cleveland Cavaliers",105,2720,0,-18,18,"2020-21",36.1111111111111
"5400",2021-02-05,"Utah Jazz",138,"Charlotte Hornets",121,0,0,-17,17,"2020-21",50
"5401",2021-02-05,"Washington Wizards",95,"Miami Heat",122,0,1,27,27,"2020-21",55.2631578947368
"5402",2021-02-05,"Minnesota Timberwolves",106,"Oklahoma City Thunder",103,0,0,-3,3,"2020-21",27.7777777777778
"5403",2021-02-05,"Detroit Pistons",92,"Phoenix Suns",109,0,1,17,17,"2020-21",74.468085106383
"5404",2021-02-05,"Boston Celtics",119,"Los Angeles Clippers",115,0,0,-4,4,"2020-21",67.3913043478261
"5405",2021-02-06,"Portland Trail Blazers",99,"New York Knicks",110,0,1,11,11,"2020-21",66.6666666666667
"5406",2021-02-06,"Denver Nuggets",114,"Sacramento Kings",119,0,1,5,5,"2020-21",44.4444444444444
"5407",2021-02-06,"Chicago Bulls",118,"Orlando Magic",92,3880,0,-26,26,"2020-21",30.5555555555556
"5408",2021-02-06,"Toronto Raptors",121,"Atlanta Hawks",132,991,1,11,11,"2020-21",65.9090909090909
"5409",2021-02-06,"Milwaukee Bucks",124,"Cleveland Cavaliers",99,2720,0,-25,25,"2020-21",36.1111111111111
"5410",2021-02-06,"San Antonio Spurs",111,"Houston Rockets",106,3313,0,-5,5,"2020-21",25
"5411",2021-02-06,"Minnesota Timberwolves",118,"Oklahoma City Thunder",120,0,1,2,2,"2020-21",27.7777777777778
"5412",2021-02-06,"Brooklyn Nets",108,"Philadelphia 76ers",124,0,1,16,16,"2020-21",76.7441860465116
"5413",2021-02-06,"Golden State Warriors",132,"Dallas Mavericks",134,0,1,2,2,"2020-21",53.8461538461538
"5414",2021-02-06,"Memphis Grizzlies",109,"New Orleans Pelicans",118,1440,1,9,9,"2020-21",50
"5415",2021-02-06,"Detroit Pistons",129,"Los Angeles Lakers",135,0,1,6,6,"2020-21",57.5
"5416",2021-02-07,"Washington Wizards",97,"Charlotte Hornets",119,0,1,22,22,"2020-21",50
"5417",2021-02-07,"Utah Jazz",103,"Indiana Pacers",95,0,0,-8,8,"2020-21",37.8378378378378
"5418",2021-02-07,"Miami Heat",109,"New York Knicks",103,0,0,-6,6,"2020-21",66.6666666666667
"5419",2021-02-07,"Boston Celtics",91,"Phoenix Suns",100,1493,1,9,9,"2020-21",74.468085106383
"5420",2021-02-07,"Sacramento Kings",113,"Los Angeles Clippers",110,0,0,-3,3,"2020-21",67.3913043478261
"5421",2021-02-08,"Houston Rockets",94,"Charlotte Hornets",119,0,1,25,25,"2020-21",50
"5422",2021-02-08,"Washington Wizards",105,"Chicago Bulls",101,0,0,-4,4,"2020-21",41.6666666666667
"5423",2021-02-08,"Toronto Raptors",128,"Memphis Grizzlies",113,1844,0,-15,15,"2020-21",48.7179487179487
"5424",2021-02-08,"Minnesota Timberwolves",122,"Dallas Mavericks",127,1000,1,5,5,"2020-21",53.8461538461538
"5425",2021-02-08,"Golden State Warriors",100,"San Antonio Spurs",105,0,1,5,5,"2020-21",38.8888888888889
"5426",2021-02-08,"Cleveland Cavaliers",113,"Phoenix Suns",119,1485,1,6,6,"2020-21",74.468085106383
"5427",2021-02-08,"Milwaukee Bucks",125,"Denver Nuggets",112,0,0,-13,13,"2020-21",65.8536585365854
"5428",2021-02-08,"Oklahoma City Thunder",112,"Los Angeles Lakers",119,0,1,7,7,"2020-21",57.5
"5429",2021-02-09,"Brooklyn Nets",111,"Detroit Pistons",122,0,1,11,11,"2020-21",36.1111111111111
"5430",2021-02-09,"New York Knicks",96,"Miami Heat",98,0,1,2,2,"2020-21",55.2631578947368
"5431",2021-02-09,"Houston Rockets",101,"New Orleans Pelicans",130,1900,1,29,29,"2020-21",50
"5432",2021-02-09,"Golden State Warriors",114,"San Antonio Spurs",91,0,0,-23,23,"2020-21",38.8888888888889
"5433",2021-02-09,"Orlando Magic",97,"Portland Trail Blazers",106,0,1,9,9,"2020-21",53.8461538461538
"5434",2021-02-09,"Philadelphia 76ers",119,"Sacramento Kings",111,0,0,-8,8,"2020-21",44.4444444444444
"5435",2021-02-09,"Boston Celtics",108,"Utah Jazz",122,3902,1,14,14,"2020-21",83.3333333333333
"5436",2021-02-10,"Toronto Raptors",137,"Washington Wizards",115,0,0,-22,22,"2020-21",53.8461538461538
"5437",2021-02-10,"Atlanta Hawks",117,"Dallas Mavericks",118,1000,1,1,1,"2020-21",53.8461538461538
"5438",2021-02-10,"Indiana Pacers",94,"Brooklyn Nets",104,0,1,10,10,"2020-21",79.0697674418605
"5439",2021-02-10,"Charlotte Hornets",114,"Memphis Grizzlies",130,1830,1,16,16,"2020-21",48.7179487179487
"5440",2021-02-10,"Los Angeles Clippers",119,"Minnesota Timberwolves",112,0,0,-7,7,"2020-21",36.1111111111111
"5441",2021-02-10,"New Orleans Pelicans",116,"Chicago Bulls",129,0,1,13,13,"2020-21",41.6666666666667
"5442",2021-02-10,"Cleveland Cavaliers",95,"Denver Nuggets",133,0,1,38,38,"2020-21",65.8536585365854
"5443",2021-02-10,"Oklahoma City Thunder",113,"Los Angeles Lakers",114,0,1,1,1,"2020-21",57.5
"5444",2021-02-10,"Milwaukee Bucks",124,"Phoenix Suns",125,1491,1,1,1,"2020-21",74.468085106383
"5445",2021-02-11,"Toronto Raptors",106,"Boston Celtics",120,0,1,14,14,"2020-21",58.974358974359
"5446",2021-02-11,"Miami Heat",101,"Houston Rockets",94,3251,0,-7,7,"2020-21",25
"5447",2021-02-11,"Indiana Pacers",111,"Detroit Pistons",95,0,0,-16,16,"2020-21",36.1111111111111
"5448",2021-02-11,"Orlando Magic",105,"Golden State Warriors",111,0,1,6,6,"2020-21",67.5675675675676
"5449",2021-02-11,"Philadelphia 76ers",114,"Portland Trail Blazers",118,0,1,4,4,"2020-21",53.8461538461538
"5450",2021-02-12,"Minnesota Timberwolves",114,"Charlotte Hornets",120,0,1,6,6,"2020-21",50
"5451",2021-02-12,"New York Knicks",109,"Washington Wizards",91,0,0,-18,18,"2020-21",53.8461538461538
"5452",2021-02-12,"San Antonio Spurs",125,"Atlanta Hawks",114,1451,0,-11,11,"2020-21",65.9090909090909
"5453",2021-02-12,"New Orleans Pelicans",130,"Dallas Mavericks",143,1514,1,13,13,"2020-21",53.8461538461538
"5454",2021-02-12,"Detroit Pistons",108,"Boston Celtics",102,0,0,-6,6,"2020-21",58.974358974359
"5455",2021-02-12,"Los Angeles Clippers",125,"Chicago Bulls",106,0,0,-19,19,"2020-21",41.6666666666667
"5456",2021-02-12,"Oklahoma City Thunder",95,"Denver Nuggets",97,0,1,2,2,"2020-21",65.8536585365854
"5457",2021-02-12,"Milwaukee Bucks",115,"Utah Jazz",129,3902,1,14,14,"2020-21",83.3333333333333
"5458",2021-02-12,"Memphis Grizzlies",105,"Los Angeles Lakers",115,0,1,10,10,"2020-21",57.5
"5459",2021-02-12,"Cleveland Cavaliers",110,"Portland Trail Blazers",129,0,1,19,19,"2020-21",53.8461538461538
"5460",2021-02-12,"Orlando Magic",123,"Sacramento Kings",112,0,0,-11,11,"2020-21",44.4444444444444
"5461",2021-02-13,"Philadelphia 76ers",111,"Phoenix Suns",120,1652,1,9,9,"2020-21",74.468085106383
"5462",2021-02-13,"Indiana Pacers",125,"Atlanta Hawks",113,1393,0,-12,12,"2020-21",65.9090909090909
"5463",2021-02-13,"Houston Rockets",99,"New York Knicks",121,0,1,22,22,"2020-21",66.6666666666667
"5464",2021-02-13,"Brooklyn Nets",134,"Golden State Warriors",117,0,0,-17,17,"2020-21",67.5675675675676
"5465",2021-02-13,"Miami Heat",94,"Utah Jazz",112,3902,1,18,18,"2020-21",83.3333333333333
"5466",2021-02-14,"Boston Celtics",91,"Washington Wizards",104,0,1,13,13,"2020-21",53.8461538461538
"5467",2021-02-14,"San Antonio Spurs",122,"Charlotte Hornets",110,0,0,-12,12,"2020-21",50
"5468",2021-02-14,"New Orleans Pelicans",112,"Detroit Pistons",123,0,1,11,11,"2020-21",36.1111111111111
"5469",2021-02-14,"Minnesota Timberwolves",116,"Toronto Raptors",112,0,0,-4,4,"2020-21",44.4444444444444
"5470",2021-02-14,"Portland Trail Blazers",121,"Dallas Mavericks",118,2211,0,-3,3,"2020-21",53.8461538461538
"5471",2021-02-14,"Milwaukee Bucks",109,"Oklahoma City Thunder",114,0,1,5,5,"2020-21",27.7777777777778
"5472",2021-02-14,"Orlando Magic",90,"Phoenix Suns",109,1732,1,19,19,"2020-21",74.468085106383
"5473",2021-02-14,"Los Angeles Lakers",105,"Denver Nuggets",122,0,1,17,17,"2020-21",65.8536585365854
"5474",2021-02-14,"Cleveland Cavaliers",111,"Los Angeles Clippers",128,0,1,17,17,"2020-21",67.3913043478261
"5475",2021-02-14,"Memphis Grizzlies",124,"Sacramento Kings",110,0,0,-14,14,"2020-21",44.4444444444444
"5476",2021-02-15,"Chicago Bulls",120,"Indiana Pacers",112,0,0,-8,8,"2020-21",37.8378378378378
"5477",2021-02-15,"Houston Rockets",119,"Washington Wizards",131,0,1,12,12,"2020-21",53.8461538461538
"5478",2021-02-15,"Atlanta Hawks",112,"New York Knicks",123,0,1,11,11,"2020-21",66.6666666666667
"5479",2021-02-15,"Philadelphia 76ers",123,"Utah Jazz",134,3902,1,11,11,"2020-21",83.3333333333333
"5480",2021-02-15,"Cleveland Cavaliers",98,"Golden State Warriors",129,0,1,31,31,"2020-21",67.5675675675676
"5481",2021-02-15,"Miami Heat",118,"Los Angeles Clippers",125,0,1,7,7,"2020-21",67.3913043478261
"5482",2021-02-15,"Brooklyn Nets",136,"Sacramento Kings",125,0,0,-11,11,"2020-21",44.4444444444444
"5483",2021-02-16,"Denver Nuggets",99,"Boston Celtics",112,0,1,13,13,"2020-21",58.974358974359
"5484",2021-02-16,"New Orleans Pelicans",144,"Memphis Grizzlies",113,1982,0,-31,31,"2020-21",48.7179487179487
"5485",2021-02-16,"Toronto Raptors",124,"Milwaukee Bucks",113,250,0,-11,11,"2020-21",76.5957446808511
"5486",2021-02-16,"Los Angeles Lakers",112,"Minnesota Timberwolves",104,0,0,-8,8,"2020-21",36.1111111111111
"5487",2021-02-16,"Portland Trail Blazers",115,"Oklahoma City Thunder",104,0,0,-11,11,"2020-21",27.7777777777778
"5488",2021-02-16,"Brooklyn Nets",128,"Phoenix Suns",124,3181,0,-4,4,"2020-21",74.468085106383
"5489",2021-02-17,"New York Knicks",89,"Orlando Magic",107,4249,1,18,18,"2020-21",30.5555555555556
"5490",2021-02-17,"Atlanta Hawks",122,"Boston Celtics",114,0,0,-8,8,"2020-21",58.974358974359
"5491",2021-02-17,"Houston Rockets",113,"Philadelphia 76ers",118,0,1,5,5,"2020-21",76.7441860465116
"5492",2021-02-17,"Detroit Pistons",102,"Chicago Bulls",105,0,1,3,3,"2020-21",41.6666666666667
"5493",2021-02-17,"Indiana Pacers",134,"Minnesota Timberwolves",128,0,0,-6,6,"2020-21",36.1111111111111
"5494",2021-02-17,"Denver Nuggets",128,"Washington Wizards",130,0,1,2,2,"2020-21",53.8461538461538
"5495",2021-02-17,"Oklahoma City Thunder",113,"Memphis Grizzlies",122,0,1,9,9,"2020-21",48.7179487179487
"5496",2021-02-17,"Portland Trail Blazers",126,"New Orleans Pelicans",124,1940,0,-2,2,"2020-21",50
"5497",2021-02-17,"Miami Heat",112,"Golden State Warriors",120,0,1,8,8,"2020-21",67.5675675675676
"5498",2021-02-17,"Utah Jazz",114,"Los Angeles Clippers",96,0,0,-18,18,"2020-21",67.3913043478261
"5499",2021-02-18,"Toronto Raptors",110,"Milwaukee Bucks",96,500,0,-14,14,"2020-21",76.5957446808511
"5500",2021-02-18,"Brooklyn Nets",109,"Los Angeles Lakers",98,0,0,-11,11,"2020-21",57.5
"5501",2021-02-18,"Miami Heat",118,"Sacramento Kings",110,0,0,-8,8,"2020-21",44.4444444444444
"5502",2021-02-19,"Denver Nuggets",120,"Cleveland Cavaliers",103,2720,0,-17,17,"2020-21",36.1111111111111
"5503",2021-02-19,"Golden State Warriors",120,"Orlando Magic",124,4287,1,4,4,"2020-21",30.5555555555556
"5504",2021-02-19,"Atlanta Hawks",109,"Boston Celtics",121,0,1,12,12,"2020-21",58.974358974359
"5505",2021-02-19,"Chicago Bulls",105,"Philadelphia 76ers",112,0,1,7,7,"2020-21",76.7441860465116
"5506",2021-02-19,"Detroit Pistons",95,"Memphis Grizzlies",109,1795,1,14,14,"2020-21",48.7179487179487
"5507",2021-02-19,"Oklahoma City Thunder",85,"Milwaukee Bucks",98,750,1,13,13,"2020-21",76.5957446808511
"5508",2021-02-19,"Phoenix Suns",132,"New Orleans Pelicans",114,1940,0,-18,18,"2020-21",50
"5509",2021-02-19,"Toronto Raptors",86,"Minnesota Timberwolves",81,0,0,-5,5,"2020-21",36.1111111111111
"5510",2021-02-19,"Utah Jazz",112,"Los Angeles Clippers",116,0,1,4,4,"2020-21",67.3913043478261
"5511",2021-02-20,"Golden State Warriors",100,"Charlotte Hornets",102,0,1,2,2,"2020-21",50
"5512",2021-02-20,"Miami Heat",96,"Los Angeles Lakers",94,0,0,-2,2,"2020-21",57.5
"5513",2021-02-20,"Sacramento Kings",114,"Chicago Bulls",122,0,1,8,8,"2020-21",41.6666666666667
"5514",2021-02-20,"Phoenix Suns",128,"Memphis Grizzlies",97,1994,0,-31,31,"2020-21",48.7179487179487
"5515",2021-02-20,"Washington Wizards",118,"Portland Trail Blazers",111,0,0,-7,7,"2020-21",53.8461538461538
"5516",2021-02-21,"Boston Celtics",115,"New Orleans Pelicans",120,1940,1,5,5,"2020-21",50
"5517",2021-02-21,"Oklahoma City Thunder",117,"Cleveland Cavaliers",101,2720,0,-16,16,"2020-21",36.1111111111111
"5518",2021-02-21,"Minnesota Timberwolves",99,"New York Knicks",103,0,1,4,4,"2020-21",66.6666666666667
"5519",2021-02-21,"Detroit Pistons",96,"Orlando Magic",105,4002,1,9,9,"2020-21",30.5555555555556
"5520",2021-02-21,"Philadelphia 76ers",103,"Toronto Raptors",110,0,1,7,7,"2020-21",44.4444444444444
"5521",2021-02-21,"Denver Nuggets",115,"Atlanta Hawks",123,1362,1,8,8,"2020-21",65.9090909090909
"5522",2021-02-21,"Brooklyn Nets",112,"Los Angeles Clippers",108,0,0,-4,4,"2020-21",67.3913043478261
"5523",2021-02-21,"Sacramento Kings",115,"Milwaukee Bucks",128,1800,1,13,13,"2020-21",76.5957446808511
"5524",2021-02-22,"Chicago Bulls",120,"Houston Rockets",100,3025,0,-20,20,"2020-21",25
"5525",2021-02-22,"Memphis Grizzlies",92,"Dallas Mavericks",102,2099,1,10,10,"2020-21",53.8461538461538
"5526",2021-02-22,"Miami Heat",108,"Oklahoma City Thunder",94,0,0,-14,14,"2020-21",27.7777777777778
"5527",2021-02-22,"Portland Trail Blazers",100,"Phoenix Suns",132,3213,1,32,32,"2020-21",74.468085106383
"5528",2021-02-22,"Charlotte Hornets",110,"Utah Jazz",132,3902,1,22,22,"2020-21",83.3333333333333
"5529",2021-02-22,"Washington Wizards",127,"Los Angeles Lakers",124,0,0,-3,3,"2020-21",57.5
"5530",2021-02-23,"Atlanta Hawks",111,"Cleveland Cavaliers",112,2720,1,1,1,"2020-21",36.1111111111111
"5531",2021-02-23,"Detroit Pistons",105,"Orlando Magic",93,3631,0,-12,12,"2020-21",30.5555555555556
"5532",2021-02-23,"Sacramento Kings",118,"Brooklyn Nets",127,324,1,9,9,"2020-21",79.0697674418605
"5533",2021-02-23,"Boston Celtics",107,"Dallas Mavericks",110,3338,1,3,3,"2020-21",53.8461538461538
"5534",2021-02-23,"Golden State Warriors",114,"New York Knicks",106,1981,0,-8,8,"2020-21",66.6666666666667
"5535",2021-02-23,"Philadelphia 76ers",109,"Toronto Raptors",102,0,0,-7,7,"2020-21",44.4444444444444
"5536",2021-02-23,"Minnesota Timberwolves",112,"Milwaukee Bucks",139,1800,1,27,27,"2020-21",76.5957446808511
"5537",2021-02-23,"Portland Trail Blazers",106,"Denver Nuggets",111,0,1,5,5,"2020-21",65.8536585365854
"5538",2021-02-23,"Washington Wizards",116,"Los Angeles Clippers",135,0,1,19,19,"2020-21",67.3913043478261
"5539",2021-02-24,"Boston Celtics",112,"Atlanta Hawks",127,1537,1,15,15,"2020-21",65.9090909090909
"5540",2021-02-24,"Houston Rockets",96,"Cleveland Cavaliers",112,2720,1,16,16,"2020-21",36.1111111111111
"5541",2021-02-24,"Golden State Warriors",111,"Indiana Pacers",107,0,0,-4,4,"2020-21",37.8378378378378
"5542",2021-02-24,"Minnesota Timberwolves",126,"Chicago Bulls",133,0,1,7,7,"2020-21",41.6666666666667
"5543",2021-02-24,"Toronto Raptors",108,"Miami Heat",116,0,1,8,8,"2020-21",55.2631578947368
"5544",2021-02-24,"Detroit Pistons",118,"New Orleans Pelicans",128,2700,1,10,10,"2020-21",50
"5545",2021-02-24,"San Antonio Spurs",99,"Oklahoma City Thunder",102,0,1,3,3,"2020-21",27.7777777777778
"5546",2021-02-24,"Charlotte Hornets",124,"Phoenix Suns",121,3296,0,-3,3,"2020-21",74.468085106383
"5547",2021-02-24,"Los Angeles Lakers",89,"Utah Jazz",114,4912,1,25,25,"2020-21",83.3333333333333
"5548",2021-02-25,"Dallas Mavericks",97,"Philadelphia 76ers",111,0,1,14,14,"2020-21",76.7441860465116
"5549",2021-02-25,"Orlando Magic",92,"Brooklyn Nets",129,327,1,37,37,"2020-21",79.0697674418605
"5550",2021-02-25,"Sacramento Kings",121,"New York Knicks",140,1981,1,19,19,"2020-21",66.6666666666667
"5551",2021-02-25,"Los Angeles Clippers",94,"Memphis Grizzlies",122,1896,1,28,28,"2020-21",48.7179487179487
"5552",2021-02-25,"Washington Wizards",112,"Denver Nuggets",110,0,0,-2,2,"2020-21",65.8536585365854
"5553",2021-02-25,"New Orleans Pelicans",125,"Milwaukee Bucks",129,1800,1,4,4,"2020-21",76.5957446808511
"5554",2021-02-26,"Indiana Pacers",112,"Boston Celtics",118,0,1,6,6,"2020-21",58.974358974359
"5555",2021-02-26,"Houston Rockets",111,"Toronto Raptors",122,0,1,11,11,"2020-21",44.4444444444444
"5556",2021-02-26,"Phoenix Suns",106,"Chicago Bulls",97,0,0,-9,9,"2020-21",41.6666666666667
"5557",2021-02-26,"Sacramento Kings",110,"Detroit Pistons",107,0,0,-3,3,"2020-21",36.1111111111111
"5558",2021-02-26,"Los Angeles Clippers",119,"Memphis Grizzlies",99,2039,0,-20,20,"2020-21",48.7179487179487
"5559",2021-02-26,"Utah Jazz",116,"Miami Heat",124,0,1,8,8,"2020-21",55.2631578947368
"5560",2021-02-26,"Atlanta Hawks",109,"Oklahoma City Thunder",118,0,1,9,9,"2020-21",27.7777777777778
"5561",2021-02-26,"Charlotte Hornets",121,"Golden State Warriors",130,0,1,9,9,"2020-21",67.5675675675676
"5562",2021-02-26,"Portland Trail Blazers",93,"Los Angeles Lakers",102,0,1,9,9,"2020-21",57.5
"5563",2021-02-27,"Cleveland Cavaliers",112,"Philadelphia 76ers",109,0,0,-3,3,"2020-21",76.7441860465116
"5564",2021-02-27,"Minnesota Timberwolves",112,"Washington Wizards",128,0,1,16,16,"2020-21",53.8461538461538
"5565",2021-02-27,"Indiana Pacers",107,"New York Knicks",110,1981,1,3,3,"2020-21",66.6666666666667
"5566",2021-02-27,"Denver Nuggets",126,"Oklahoma City Thunder",96,0,0,-30,30,"2020-21",27.7777777777778
"5567",2021-02-27,"Utah Jazz",124,"Orlando Magic",109,4242,0,-15,15,"2020-21",30.5555555555556
"5568",2021-02-27,"New Orleans Pelicans",114,"San Antonio Spurs",117,0,1,3,3,"2020-21",38.8888888888889
"5569",2021-02-27,"Dallas Mavericks",115,"Brooklyn Nets",98,684,0,-17,17,"2020-21",79.0697674418605
"5570",2021-02-28,"Los Angeles Clippers",100,"Milwaukee Bucks",105,1800,1,5,5,"2020-21",76.5957446808511
"5571",2021-02-28,"Washington Wizards",110,"Boston Celtics",111,0,1,1,1,"2020-21",58.974358974359
"5572",2021-02-28,"New York Knicks",109,"Detroit Pistons",90,0,0,-19,19,"2020-21",36.1111111111111
"5573",2021-02-28,"Memphis Grizzlies",133,"Houston Rockets",84,3284,0,-49,49,"2020-21",25
"5574",2021-02-28,"Golden State Warriors",91,"Los Angeles Lakers",117,0,1,26,26,"2020-21",57.5
"5575",2021-02-28,"Atlanta Hawks",99,"Miami Heat",109,0,1,10,10,"2020-21",55.2631578947368
"5576",2021-02-28,"Phoenix Suns",118,"Minnesota Timberwolves",99,0,0,-19,19,"2020-21",36.1111111111111
"5577",2021-02-28,"Charlotte Hornets",127,"Sacramento Kings",126,0,0,-1,1,"2020-21",44.4444444444444
"5578",2021-03-01,"Dallas Mavericks",130,"Orlando Magic",124,3766,0,-6,6,"2020-21",30.5555555555556
"5579",2021-03-01,"Indiana Pacers",114,"Philadelphia 76ers",130,0,1,16,16,"2020-21",76.7441860465116
"5580",2021-03-01,"Denver Nuggets",118,"Chicago Bulls",112,0,0,-6,6,"2020-21",41.6666666666667
"5581",2021-03-01,"Utah Jazz",124,"New Orleans Pelicans",129,2700,1,5,5,"2020-21",50
"5582",2021-03-01,"Brooklyn Nets",124,"San Antonio Spurs",113,0,0,-11,11,"2020-21",38.8888888888889
"5583",2021-03-01,"Cleveland Cavaliers",101,"Houston Rockets",90,3046,0,-11,11,"2020-21",25
"5584",2021-03-01,"Charlotte Hornets",111,"Portland Trail Blazers",123,0,1,12,12,"2020-21",53.8461538461538
"5585",2021-03-02,"Memphis Grizzlies",125,"Washington Wizards",111,0,0,-14,14,"2020-21",53.8461538461538
"5586",2021-03-02,"Los Angeles Clippers",112,"Boston Celtics",117,0,1,5,5,"2020-21",58.974358974359
"5587",2021-03-02,"Atlanta Hawks",94,"Miami Heat",80,0,0,-14,14,"2020-21",55.2631578947368
"5588",2021-03-02,"New York Knicks",93,"San Antonio Spurs",119,0,1,26,26,"2020-21",38.8888888888889
"5589",2021-03-02,"Denver Nuggets",128,"Milwaukee Bucks",97,1800,0,-31,31,"2020-21",76.5957446808511
"5590",2021-03-02,"Phoenix Suns",114,"Los Angeles Lakers",104,0,0,-10,10,"2020-21",57.5
"5591",2021-03-03,"Indiana Pacers",114,"Cleveland Cavaliers",111,2720,0,-3,3,"2020-21",36.1111111111111
"5592",2021-03-03,"Utah Jazz",123,"Philadelphia 76ers",131,0,1,8,8,"2020-21",76.7441860465116
"5593",2021-03-03,"Detroit Pistons",129,"Toronto Raptors",105,0,0,-24,24,"2020-21",44.4444444444444
"5594",2021-03-03,"Brooklyn Nets",132,"Houston Rockets",114,3615,0,-18,18,"2020-21",25
"5595",2021-03-03,"Charlotte Hornets",135,"Minnesota Timberwolves",102,0,0,-33,33,"2020-21",36.1111111111111
"5596",2021-03-03,"Chicago Bulls",128,"New Orleans Pelicans",124,2700,0,-4,4,"2020-21",50
"5597",2021-03-03,"Atlanta Hawks",115,"Orlando Magic",112,3969,0,-3,3,"2020-21",30.5555555555556
"5598",2021-03-03,"Oklahoma City Thunder",78,"Dallas Mavericks",87,3508,1,9,9,"2020-21",53.8461538461538
"5599",2021-03-03,"Golden State Warriors",106,"Portland Trail Blazers",108,0,1,2,2,"2020-21",53.8461538461538
"5600",2021-03-03,"Los Angeles Lakers",120,"Sacramento Kings",123,0,1,3,3,"2020-21",44.4444444444444
"5601",2021-03-04,"Toronto Raptors",125,"Boston Celtics",132,0,1,7,7,"2020-21",58.974358974359
"5602",2021-03-04,"Los Angeles Clippers",117,"Washington Wizards",119,0,1,2,2,"2020-21",53.8461538461538
"5603",2021-03-04,"Detroit Pistons",104,"New York Knicks",114,1981,1,10,10,"2020-21",66.6666666666667
"5604",2021-03-04,"Denver Nuggets",113,"Indiana Pacers",103,0,0,-10,10,"2020-21",37.8378378378378
"5605",2021-03-04,"Milwaukee Bucks",112,"Memphis Grizzlies",111,1961,0,-1,1,"2020-21",48.7179487179487
"5606",2021-03-04,"Miami Heat",103,"New Orleans Pelicans",93,2700,0,-10,10,"2020-21",50
"5607",2021-03-04,"Oklahoma City Thunder",107,"San Antonio Spurs",102,1000,0,-5,5,"2020-21",38.8888888888889
"5608",2021-03-04,"Golden State Warriors",98,"Phoenix Suns",120,3233,1,22,22,"2020-21",74.468085106383
"5609",2021-03-04,"Sacramento Kings",119,"Portland Trail Blazers",123,0,1,4,4,"2020-21",53.8461538461538
"5610",2021-03-10,"Washington Wizards",112,"Memphis Grizzlies",127,1912,1,15,15,"2020-21",48.7179487179487
"5611",2021-03-10,"San Antonio Spurs",104,"Dallas Mavericks",115,3813,1,11,11,"2020-21",53.8461538461538
"5612",2021-03-11,"Detroit Pistons",102,"Charlotte Hornets",105,0,1,3,3,"2020-21",50
"5613",2021-03-11,"Boston Celtics",109,"Brooklyn Nets",121,1374,1,12,12,"2020-21",79.0697674418605
"5614",2021-03-11,"Atlanta Hawks",121,"Toronto Raptors",120,0,0,-1,1,"2020-21",44.4444444444444
"5615",2021-03-11,"Philadelphia 76ers",127,"Chicago Bulls",105,0,0,-22,22,"2020-21",41.6666666666667
"5616",2021-03-11,"Orlando Magic",103,"Miami Heat",111,0,1,8,8,"2020-21",55.2631578947368
"5617",2021-03-11,"New York Knicks",101,"Milwaukee Bucks",134,1800,1,33,33,"2020-21",76.5957446808511
"5618",2021-03-11,"Minnesota Timberwolves",135,"New Orleans Pelicans",105,3700,0,-30,30,"2020-21",50
"5619",2021-03-11,"Dallas Mavericks",108,"Oklahoma City Thunder",116,0,1,8,8,"2020-21",27.7777777777778
"5620",2021-03-11,"Golden State Warriors",104,"Los Angeles Clippers",130,0,1,26,26,"2020-21",67.3913043478261
"5621",2021-03-11,"Phoenix Suns",127,"Portland Trail Blazers",121,0,0,-6,6,"2020-21",53.8461538461538
"5622",2021-03-11,"Houston Rockets",105,"Sacramento Kings",125,0,1,20,20,"2020-21",44.4444444444444
"5623",2021-03-12,"Denver Nuggets",103,"Memphis Grizzlies",102,2160,0,-1,1,"2020-21",48.7179487179487
"5624",2021-03-12,"Cleveland Cavaliers",82,"New Orleans Pelicans",116,3700,1,34,34,"2020-21",50
"5625",2021-03-12,"Philadelphia 76ers",127,"Washington Wizards",101,0,0,-26,26,"2020-21",53.8461538461538
"5626",2021-03-12,"Miami Heat",101,"Chicago Bulls",90,0,0,-11,11,"2020-21",41.6666666666667
"5627",2021-03-12,"Orlando Magic",77,"San Antonio Spurs",104,3241,1,27,27,"2020-21",38.8888888888889
"5628",2021-03-12,"Houston Rockets",99,"Utah Jazz",114,5546,1,15,15,"2020-21",83.3333333333333
"5629",2021-03-12,"Indiana Pacers",100,"Los Angeles Lakers",105,0,1,5,5,"2020-21",57.5
"5630",2021-03-13,"New York Knicks",119,"Oklahoma City Thunder",97,0,0,-22,22,"2020-21",27.7777777777778
"5631",2021-03-13,"Detroit Pistons",95,"Brooklyn Nets",100,1364,1,5,5,"2020-21",79.0697674418605
"5632",2021-03-13,"Toronto Raptors",104,"Charlotte Hornets",114,2861,1,10,10,"2020-21",50
"5633",2021-03-13,"Milwaukee Bucks",125,"Washington Wizards",119,0,0,-6,6,"2020-21",53.8461538461538
"5634",2021-03-13,"Sacramento Kings",106,"Atlanta Hawks",121,2347,1,15,15,"2020-21",65.9090909090909
"5635",2021-03-13,"Portland Trail Blazers",125,"Minnesota Timberwolves",121,0,0,-4,4,"2020-21",36.1111111111111
"5636",2021-03-13,"Dallas Mavericks",116,"Denver Nuggets",103,0,0,-13,13,"2020-21",65.8536585365854
"5637",2021-03-13,"Indiana Pacers",122,"Phoenix Suns",111,3166,0,-11,11,"2020-21",74.468085106383
"5638",2021-03-14,"Memphis Grizzlies",122,"Oklahoma City Thunder",128,0,1,6,6,"2020-21",27.7777777777778
"5639",2021-03-14,"Utah Jazz",119,"Golden State Warriors",131,0,1,12,12,"2020-21",67.5675675675676
"5640",2021-03-14,"San Antonio Spurs",99,"Philadelphia 76ers",134,3071,1,35,35,"2020-21",76.7441860465116
"5641",2021-03-14,"Miami Heat",102,"Orlando Magic",97,3264,0,-5,5,"2020-21",30.5555555555556
"5642",2021-03-14,"Cleveland Cavaliers",82,"Atlanta Hawks",100,2322,1,18,18,"2020-21",65.9090909090909
"5643",2021-03-14,"Boston Celtics",134,"Houston Rockets",107,3264,0,-27,27,"2020-21",25
"5644",2021-03-14,"Portland Trail Blazers",112,"Minnesota Timberwolves",114,0,1,2,2,"2020-21",36.1111111111111
"5645",2021-03-14,"Toronto Raptors",95,"Chicago Bulls",118,0,1,23,23,"2020-21",41.6666666666667
"5646",2021-03-14,"Los Angeles Clippers",115,"New Orleans Pelicans",135,3700,1,20,20,"2020-21",50
"5647",2021-03-15,"Sacramento Kings",116,"Charlotte Hornets",122,2861,1,6,6,"2020-21",50
"5648",2021-03-15,"Milwaukee Bucks",133,"Washington Wizards",122,0,0,-11,11,"2020-21",53.8461538461538
"5649",2021-03-15,"New York Knicks",112,"Brooklyn Nets",117,1637,1,5,5,"2020-21",79.0697674418605
"5650",2021-03-15,"San Antonio Spurs",109,"Detroit Pistons",99,0,0,-10,10,"2020-21",36.1111111111111
"5651",2021-03-15,"Los Angeles Clippers",109,"Dallas Mavericks",99,3945,0,-10,10,"2020-21",53.8461538461538
"5652",2021-03-15,"Indiana Pacers",106,"Denver Nuggets",121,0,1,15,15,"2020-21",65.8536585365854
"5653",2021-03-15,"Memphis Grizzlies",99,"Phoenix Suns",122,3188,1,23,23,"2020-21",74.468085106383
"5654",2021-03-15,"Los Angeles Lakers",128,"Golden State Warriors",97,0,0,-31,31,"2020-21",67.5675675675676
"5655",2021-03-16,"Utah Jazz",117,"Boston Celtics",109,0,0,-8,8,"2020-21",58.974358974359
"5656",2021-03-16,"Oklahoma City Thunder",102,"Chicago Bulls",123,0,1,21,21,"2020-21",41.6666666666667
"5657",2021-03-16,"Atlanta Hawks",119,"Houston Rockets",107,3069,0,-12,12,"2020-21",25
"5658",2021-03-16,"Cleveland Cavaliers",98,"Miami Heat",113,0,1,15,15,"2020-21",55.2631578947368
"5659",2021-03-16,"New York Knicks",96,"Philadelphia 76ers",99,3071,1,3,3,"2020-21",76.7441860465116
"5660",2021-03-16,"New Orleans Pelicans",124,"Portland Trail Blazers",125,0,1,1,1,"2020-21",53.8461538461538
"5661",2021-03-16,"Minnesota Timberwolves",121,"Los Angeles Lakers",137,0,1,16,16,"2020-21",57.5
"5662",2021-03-17,"Toronto Raptors",112,"Detroit Pistons",116,750,1,4,4,"2020-21",36.1111111111111
"5663",2021-03-17,"Brooklyn Nets",124,"Indiana Pacers",115,0,0,-9,9,"2020-21",37.8378378378378
"5664",2021-03-17,"Milwaukee Bucks",109,"Philadelphia 76ers",105,3071,0,-4,4,"2020-21",76.7441860465116
"5665",2021-03-17,"Sacramento Kings",121,"Washington Wizards",119,0,0,-2,2,"2020-21",53.8461538461538
"5666",2021-03-17,"San Antonio Spurs",106,"Chicago Bulls",99,0,0,-7,7,"2020-21",41.6666666666667
"5667",2021-03-17,"Boston Celtics",110,"Cleveland Cavaliers",117,4100,1,7,7,"2020-21",36.1111111111111
"5668",2021-03-17,"Golden State Warriors",108,"Houston Rockets",94,3259,0,-14,14,"2020-21",25
"5669",2021-03-17,"Charlotte Hornets",104,"Denver Nuggets",129,0,1,25,25,"2020-21",65.8536585365854
"5670",2021-03-17,"Miami Heat",85,"Memphis Grizzlies",89,2217,1,4,4,"2020-21",48.7179487179487
"5671",2021-03-17,"Los Angeles Clippers",89,"Dallas Mavericks",105,3975,1,16,16,"2020-21",53.8461538461538
"5672",2021-03-18,"Utah Jazz",122,"Washington Wizards",131,0,1,9,9,"2020-21",53.8461538461538
"5673",2021-03-18,"Oklahoma City Thunder",93,"Atlanta Hawks",116,2621,1,23,23,"2020-21",65.9090909090909
"5674",2021-03-18,"Orlando Magic",93,"New York Knicks",94,1531,1,1,1,"2020-21",66.6666666666667
"5675",2021-03-18,"Minnesota Timberwolves",123,"Phoenix Suns",119,3172,0,-4,4,"2020-21",74.468085106383
"5676",2021-03-18,"New Orleans Pelicans",93,"Portland Trail Blazers",101,0,1,8,8,"2020-21",53.8461538461538
"5677",2021-03-18,"Charlotte Hornets",105,"Los Angeles Lakers",116,0,1,11,11,"2020-21",57.5
"5678",2021-03-19,"Sacramento Kings",107,"Boston Celtics",96,0,0,-11,11,"2020-21",58.974358974359
"5679",2021-03-19,"San Antonio Spurs",116,"Cleveland Cavaliers",110,0,0,-6,6,"2020-21",36.1111111111111
"5680",2021-03-19,"Detroit Pistons",113,"Houston Rockets",100,3061,0,-13,13,"2020-21",25
"5681",2021-03-19,"Golden State Warriors",116,"Memphis Grizzlies",103,2716,0,-13,13,"2020-21",48.7179487179487
"5682",2021-03-19,"Indiana Pacers",137,"Miami Heat",110,0,0,-27,27,"2020-21",55.2631578947368
"5683",2021-03-19,"Brooklyn Nets",113,"Orlando Magic",121,3665,1,8,8,"2020-21",30.5555555555556
"5684",2021-03-19,"Utah Jazz",115,"Toronto Raptors",112,0,0,-3,3,"2020-21",44.4444444444444
"5685",2021-03-19,"Chicago Bulls",127,"Denver Nuggets",131,0,1,4,4,"2020-21",65.8536585365854
"5686",2021-03-19,"Minnesota Timberwolves",101,"Phoenix Suns",113,3124,1,12,12,"2020-21",74.468085106383
"5687",2021-03-19,"Dallas Mavericks",119,"Portland Trail Blazers",125,0,1,6,6,"2020-21",53.8461538461538
"5688",2021-03-20,"Atlanta Hawks",99,"Los Angeles Lakers",94,0,0,-5,5,"2020-21",57.5
"5689",2021-03-20,"Golden State Warriors",103,"Memphis Grizzlies",111,0,1,8,8,"2020-21",48.7179487179487
"5690",2021-03-20,"Sacramento Kings",105,"Philadelphia 76ers",129,3071,1,24,24,"2020-21",76.7441860465116
"5691",2021-03-20,"San Antonio Spurs",113,"Milwaukee Bucks",120,3280,1,7,7,"2020-21",76.5957446808511
"5692",2021-03-20,"Charlotte Hornets",98,"Los Angeles Clippers",125,0,1,27,27,"2020-21",67.3913043478261
"5693",2021-03-21,"Indiana Pacers",109,"Miami Heat",106,0,0,-3,3,"2020-21",55.2631578947368
"5694",2021-03-21,"Oklahoma City Thunder",114,"Houston Rockets",112,3297,0,-2,2,"2020-21",25
"5695",2021-03-21,"New Orleans Pelicans",113,"Denver Nuggets",108,0,0,-5,5,"2020-21",65.8536585365854
"5696",2021-03-21,"Orlando Magic",96,"Boston Celtics",112,0,1,16,16,"2020-21",58.974358974359
"5697",2021-03-21,"Washington Wizards",106,"Brooklyn Nets",113,1773,1,7,7,"2020-21",79.0697674418605
"5698",2021-03-21,"Toronto Raptors",105,"Cleveland Cavaliers",116,0,1,11,11,"2020-21",36.1111111111111
"5699",2021-03-21,"Chicago Bulls",100,"Detroit Pistons",86,750,0,-14,14,"2020-21",36.1111111111111
"5700",2021-03-21,"Philadelphia 76ers",101,"New York Knicks",100,1981,0,-1,1,"2020-21",66.6666666666667
"5701",2021-03-21,"Los Angeles Lakers",94,"Phoenix Suns",111,3190,1,17,17,"2020-21",74.468085106383
"5702",2021-03-21,"Dallas Mavericks",132,"Portland Trail Blazers",92,0,0,-40,40,"2020-21",53.8461538461538
"5703",2021-03-22,"Sacramento Kings",119,"Cleveland Cavaliers",105,4100,0,-14,14,"2020-21",36.1111111111111
"5704",2021-03-22,"Oklahoma City Thunder",112,"Minnesota Timberwolves",103,0,0,-9,9,"2020-21",36.1111111111111
"5705",2021-03-22,"Charlotte Hornets",100,"San Antonio Spurs",97,3222,0,-3,3,"2020-21",38.8888888888889
"5706",2021-03-22,"Utah Jazz",120,"Chicago Bulls",95,0,0,-25,25,"2020-21",41.6666666666667
"5707",2021-03-22,"Toronto Raptors",99,"Houston Rockets",117,2965,1,18,18,"2020-21",25
"5708",2021-03-22,"Boston Celtics",126,"Memphis Grizzlies",132,2319,1,6,6,"2020-21",48.7179487179487
"5709",2021-03-22,"Indiana Pacers",113,"Milwaukee Bucks",140,3280,1,27,27,"2020-21",76.5957446808511
"5710",2021-03-22,"Atlanta Hawks",110,"Los Angeles Clippers",119,0,1,9,9,"2020-21",67.3913043478261
"5711",2021-03-23,"Denver Nuggets",110,"Orlando Magic",99,3485,0,-11,11,"2020-21",30.5555555555556
"5712",2021-03-23,"Los Angeles Lakers",111,"New Orleans Pelicans",128,3700,1,17,17,"2020-21",50
"5713",2021-03-23,"Washington Wizards",113,"New York Knicks",131,1589,1,18,18,"2020-21",66.6666666666667
"5714",2021-03-23,"Phoenix Suns",110,"Miami Heat",100,0,0,-10,10,"2020-21",55.2631578947368
"5715",2021-03-23,"Philadelphia 76ers",108,"Golden State Warriors",98,0,0,-10,10,"2020-21",67.5675675675676
"5716",2021-03-23,"Brooklyn Nets",116,"Portland Trail Blazers",112,0,0,-4,4,"2020-21",53.8461538461538
"5717",2021-03-24,"Detroit Pistons",111,"Indiana Pacers",116,0,1,5,5,"2020-21",37.8378378378378
"5718",2021-03-24,"Boston Celtics",119,"Milwaukee Bucks",121,3280,1,2,2,"2020-21",76.5957446808511
"5719",2021-03-24,"Denver Nuggets",111,"Toronto Raptors",135,1578,1,24,24,"2020-21",44.4444444444444
"5720",2021-03-24,"Cleveland Cavaliers",103,"Chicago Bulls",94,0,0,-9,9,"2020-21",41.6666666666667
"5721",2021-03-24,"Charlotte Hornets",122,"Houston Rockets",97,3163,0,-25,25,"2020-21",25
"5722",2021-03-24,"Dallas Mavericks",128,"Minnesota Timberwolves",108,0,0,-20,20,"2020-21",36.1111111111111
"5723",2021-03-24,"Memphis Grizzlies",116,"Oklahoma City Thunder",107,0,0,-9,9,"2020-21",27.7777777777778
"5724",2021-03-24,"Phoenix Suns",111,"Orlando Magic",112,3891,1,1,1,"2020-21",30.5555555555556
"5725",2021-03-24,"Los Angeles Clippers",134,"San Antonio Spurs",101,3224,0,-33,33,"2020-21",38.8888888888889
"5726",2021-03-24,"Atlanta Hawks",108,"Sacramento Kings",110,0,1,2,2,"2020-21",44.4444444444444
"5727",2021-03-24,"Brooklyn Nets",88,"Utah Jazz",118,5546,1,30,30,"2020-21",83.3333333333333
"5728",2021-03-25,"Portland Trail Blazers",125,"Miami Heat",122,0,0,-3,3,"2020-21",55.2631578947368
"5729",2021-03-25,"Washington Wizards",102,"New York Knicks",106,1817,1,4,4,"2020-21",66.6666666666667
"5730",2021-03-25,"Los Angeles Clippers",98,"San Antonio Spurs",85,3225,0,-13,13,"2020-21",38.8888888888889
"5731",2021-03-25,"Philadelphia 76ers",109,"Los Angeles Lakers",101,0,0,-8,8,"2020-21",57.5
"5732",2021-03-25,"Golden State Warriors",119,"Sacramento Kings",141,0,1,22,22,"2020-21",44.4444444444444
"5733",2021-03-26,"Brooklyn Nets",113,"Detroit Pistons",111,750,0,-2,2,"2020-21",36.1111111111111
"5734",2021-03-26,"Boston Celtics",122,"Milwaukee Bucks",114,3280,0,-8,8,"2020-21",76.5957446808511
"5735",2021-03-26,"Phoenix Suns",104,"Toronto Raptors",100,0,0,-4,4,"2020-21",44.4444444444444
"5736",2021-03-26,"Miami Heat",105,"Charlotte Hornets",110,4215,1,5,5,"2020-21",50
"5737",2021-03-26,"Houston Rockets",101,"Minnesota Timberwolves",107,0,1,6,6,"2020-21",36.1111111111111
"5738",2021-03-26,"Denver Nuggets",113,"New Orleans Pelicans",108,3700,0,-5,5,"2020-21",50
"5739",2021-03-26,"Portland Trail Blazers",112,"Orlando Magic",105,3827,0,-7,7,"2020-21",30.5555555555556
"5740",2021-03-26,"Indiana Pacers",109,"Dallas Mavericks",94,4132,0,-15,15,"2020-21",53.8461538461538
"5741",2021-03-26,"Memphis Grizzlies",114,"Utah Jazz",117,5546,1,3,3,"2020-21",83.3333333333333
"5742",2021-03-26,"Atlanta Hawks",124,"Golden State Warriors",108,0,0,-16,16,"2020-21",67.5675675675676
"5743",2021-03-26,"Cleveland Cavaliers",86,"Los Angeles Lakers",100,0,1,14,14,"2020-21",57.5
"5744",2021-03-27,"New York Knicks",102,"Milwaukee Bucks",96,3280,0,-6,6,"2020-21",76.5957446808511
"5745",2021-03-27,"Houston Rockets",129,"Minnesota Timberwolves",107,0,0,-22,22,"2020-21",36.1111111111111
"5746",2021-03-27,"Detroit Pistons",92,"Washington Wizards",106,0,1,14,14,"2020-21",53.8461538461538
"5747",2021-03-27,"Chicago Bulls",104,"San Antonio Spurs",120,3334,1,16,16,"2020-21",38.8888888888889
"5748",2021-03-27,"Dallas Mavericks",103,"New Orleans Pelicans",112,3700,1,9,9,"2020-21",50
"5749",2021-03-27,"Boston Celtics",111,"Oklahoma City Thunder",94,0,0,-17,17,"2020-21",27.7777777777778
"5750",2021-03-27,"Memphis Grizzlies",110,"Utah Jazz",126,5546,1,16,16,"2020-21",83.3333333333333
"5751",2021-03-27,"Philadelphia 76ers",112,"Los Angeles Clippers",122,0,1,10,10,"2020-21",67.3913043478261
"5752",2021-03-27,"Cleveland Cavaliers",98,"Sacramento Kings",100,0,1,2,2,"2020-21",44.4444444444444
"5753",2021-03-28,"Phoenix Suns",101,"Charlotte Hornets",97,3850,0,-4,4,"2020-21",50
"5754",2021-03-28,"Portland Trail Blazers",122,"Toronto Raptors",117,2021,0,-5,5,"2020-21",44.4444444444444
"5755",2021-03-28,"Atlanta Hawks",102,"Denver Nuggets",126,0,1,24,24,"2020-21",65.8536585365854
"5756",2021-03-28,"Orlando Magic",93,"Los Angeles Lakers",96,0,1,3,3,"2020-21",57.5
"5757",2021-03-29,"Indiana Pacers",124,"Washington Wizards",132,0,1,8,8,"2020-21",53.8461538461538
"5758",2021-03-29,"New Orleans Pelicans",115,"Boston Celtics",109,2298,0,-6,6,"2020-21",58.974358974359
"5759",2021-03-29,"Minnesota Timberwolves",107,"Brooklyn Nets",112,1732,1,5,5,"2020-21",79.0697674418605
"5760",2021-03-29,"Miami Heat",98,"New York Knicks",88,1981,0,-10,10,"2020-21",66.6666666666667
"5761",2021-03-29,"Toronto Raptors",104,"Detroit Pistons",118,750,1,14,14,"2020-21",36.1111111111111
"5762",2021-03-29,"Memphis Grizzlies",120,"Houston Rockets",110,3319,0,-10,10,"2020-21",25
"5763",2021-03-29,"Dallas Mavericks",127,"Oklahoma City Thunder",106,0,0,-21,21,"2020-21",27.7777777777778
"5764",2021-03-29,"Sacramento Kings",132,"San Antonio Spurs",115,2876,0,-17,17,"2020-21",38.8888888888889
"5765",2021-03-29,"Cleveland Cavaliers",75,"Utah Jazz",114,5546,1,39,39,"2020-21",83.3333333333333
"5766",2021-03-29,"Chicago Bulls",102,"Golden State Warriors",116,0,1,14,14,"2020-21",67.5675675675676
"5767",2021-03-29,"Milwaukee Bucks",105,"Los Angeles Clippers",129,0,1,24,24,"2020-21",67.3913043478261
"5768",2021-03-30,"Charlotte Hornets",114,"Washington Wizards",104,0,0,-10,10,"2020-21",53.8461538461538
"5769",2021-03-30,"Philadelphia 76ers",95,"Denver Nuggets",104,3574,1,9,9,"2020-21",65.8536585365854
"5770",2021-03-30,"Orlando Magic",103,"Los Angeles Clippers",96,0,0,-7,7,"2020-21",67.3913043478261
"5771",2021-03-30,"Atlanta Hawks",110,"Phoenix Suns",117,3173,1,7,7,"2020-21",74.468085106383
"5772",2021-03-31,"Portland Trail Blazers",124,"Detroit Pistons",101,750,0,-23,23,"2020-21",36.1111111111111
"5773",2021-03-31,"Miami Heat",92,"Indiana Pacers",87,0,0,-5,5,"2020-21",37.8378378378378
"5774",2021-03-31,"Dallas Mavericks",113,"Boston Celtics",108,2298,0,-5,5,"2020-21",58.974358974359
"5775",2021-03-31,"Houston Rockets",108,"Brooklyn Nets",120,1773,1,12,12,"2020-21",79.0697674418605
"5776",2021-03-31,"Utah Jazz",111,"Memphis Grizzlies",107,2314,0,-4,4,"2020-21",48.7179487179487
"5777",2021-03-31,"New York Knicks",101,"Minnesota Timberwolves",102,0,1,1,1,"2020-21",36.1111111111111
"5778",2021-03-31,"Toronto Raptors",103,"Oklahoma City Thunder",113,0,1,10,10,"2020-21",27.7777777777778
"5779",2021-03-31,"Sacramento Kings",106,"San Antonio Spurs",120,2802,1,14,14,"2020-21",38.8888888888889
"5780",2021-03-31,"Milwaukee Bucks",112,"Los Angeles Lakers",97,0,0,-15,15,"2020-21",57.5
"5781",2021-03-31,"Chicago Bulls",116,"Phoenix Suns",121,3459,1,5,5,"2020-21",74.468085106383
"5782",2021-04-01,"Philadelphia 76ers",114,"Cleveland Cavaliers",94,4100,0,-20,20,"2020-21",36.1111111111111
"5783",2021-04-01,"Washington Wizards",91,"Detroit Pistons",120,750,1,29,29,"2020-21",36.1111111111111
"5784",2021-04-01,"Charlotte Hornets",89,"Brooklyn Nets",111,1773,1,22,22,"2020-21",79.0697674418605
"5785",2021-04-01,"Golden State Warriors",109,"Miami Heat",116,0,1,7,7,"2020-21",55.2631578947368
"5786",2021-04-01,"Orlando Magic",115,"New Orleans Pelicans",110,3700,0,-5,5,"2020-21",50
"5787",2021-04-01,"Atlanta Hawks",134,"San Antonio Spurs",129,2949,0,-5,5,"2020-21",38.8888888888889
"5788",2021-04-01,"Denver Nuggets",101,"Los Angeles Clippers",94,0,0,-7,7,"2020-21",67.3913043478261
"5789",2021-04-02,"Golden State Warriors",77,"Toronto Raptors",130,3085,1,53,53,"2020-21",44.4444444444444
"5790",2021-04-02,"Houston Rockets",102,"Boston Celtics",118,0,1,16,16,"2020-21",58.974358974359
"5791",2021-04-02,"Dallas Mavericks",99,"New York Knicks",86,1981,0,-13,13,"2020-21",66.6666666666667
"5792",2021-04-02,"Charlotte Hornets",114,"Indiana Pacers",97,0,0,-17,17,"2020-21",37.8378378378378
"5793",2021-04-02,"Minnesota Timberwolves",108,"Memphis Grizzlies",120,2987,1,12,12,"2020-21",48.7179487179487
"5794",2021-04-02,"Atlanta Hawks",126,"New Orleans Pelicans",103,3700,0,-23,23,"2020-21",50
"5795",2021-04-02,"Chicago Bulls",106,"Utah Jazz",113,5546,1,7,7,"2020-21",83.3333333333333
"5796",2021-04-02,"Oklahoma City Thunder",103,"Phoenix Suns",140,3422,1,37,37,"2020-21",74.468085106383
"5797",2021-04-02,"Milwaukee Bucks",127,"Portland Trail Blazers",109,0,0,-18,18,"2020-21",53.8461538461538
"5798",2021-04-02,"Los Angeles Lakers",115,"Sacramento Kings",94,0,0,-21,21,"2020-21",44.4444444444444
"5799",2021-04-03,"Dallas Mavericks",109,"Washington Wizards",87,0,0,-22,22,"2020-21",53.8461538461538
"5800",2021-04-03,"New York Knicks",125,"Detroit Pistons",81,750,0,-44,44,"2020-21",36.1111111111111
"5801",2021-04-03,"Cleveland Cavaliers",101,"Miami Heat",115,0,1,14,14,"2020-21",55.2631578947368
"5802",2021-04-03,"Minnesota Timberwolves",113,"Philadelphia 76ers",122,3071,1,9,9,"2020-21",76.7441860465116
"5803",2021-04-03,"Indiana Pacers",139,"San Antonio Spurs",133,3276,0,-6,6,"2020-21",38.8888888888889
"5804",2021-04-03,"Orlando Magic",91,"Utah Jazz",137,5546,1,46,46,"2020-21",83.3333333333333
"5805",2021-04-03,"Oklahoma City Thunder",85,"Portland Trail Blazers",133,0,1,48,48,"2020-21",53.8461538461538
"5806",2021-04-03,"Milwaukee Bucks",129,"Sacramento Kings",128,0,0,-1,1,"2020-21",44.4444444444444
"5807",2021-04-04,"Brooklyn Nets",107,"Chicago Bulls",115,0,1,8,8,"2020-21",41.6666666666667
"5808",2021-04-04,"Los Angeles Lakers",86,"Los Angeles Clippers",104,0,1,18,18,"2020-21",67.3913043478261
"5809",2021-04-04,"Charlotte Hornets",86,"Boston Celtics",116,0,1,30,30,"2020-21",58.974358974359
"5810",2021-04-04,"Memphis Grizzlies",116,"Philadelphia 76ers",100,4094,0,-16,16,"2020-21",76.7441860465116
"5811",2021-04-04,"Golden State Warriors",111,"Atlanta Hawks",117,2937,1,6,6,"2020-21",65.9090909090909
"5812",2021-04-04,"New Orleans Pelicans",122,"Houston Rockets",115,3268,0,-7,7,"2020-21",25
"5813",2021-04-04,"Orlando Magic",109,"Denver Nuggets",119,3927,1,10,10,"2020-21",65.8536585365854
"5814",2021-04-05,"New York Knicks",112,"Brooklyn Nets",114,1773,1,2,2,"2020-21",79.0697674418605
"5815",2021-04-05,"Utah Jazz",103,"Dallas Mavericks",111,4261,1,8,8,"2020-21",53.8461538461538
"5816",2021-04-05,"Sacramento Kings",106,"Minnesota Timberwolves",116,1436,1,10,10,"2020-21",36.1111111111111
"5817",2021-04-05,"Detroit Pistons",132,"Oklahoma City Thunder",108,0,0,-24,24,"2020-21",27.7777777777778
"5818",2021-04-05,"Cleveland Cavaliers",125,"San Antonio Spurs",101,2482,0,-24,24,"2020-21",38.8888888888889
"5819",2021-04-05,"Washington Wizards",101,"Toronto Raptors",103,1620,1,2,2,"2020-21",44.4444444444444
"5820",2021-04-05,"Phoenix Suns",133,"Houston Rockets",130,3093,0,-3,3,"2020-21",25
"5821",2021-04-06,"Chicago Bulls",113,"Indiana Pacers",97,0,0,-16,16,"2020-21",37.8378378378378
"5822",2021-04-06,"New Orleans Pelicans",107,"Atlanta Hawks",123,2816,1,16,16,"2020-21",65.9090909090909
"5823",2021-04-06,"Philadelphia 76ers",106,"Boston Celtics",96,2298,0,-10,10,"2020-21",58.974358974359
"5824",2021-04-06,"Los Angeles Lakers",110,"Toronto Raptors",101,0,0,-9,9,"2020-21",44.4444444444444
"5825",2021-04-06,"Memphis Grizzlies",124,"Miami Heat",112,0,0,-12,12,"2020-21",55.2631578947368
"5826",2021-04-06,"Detroit Pistons",119,"Denver Nuggets",134,3556,1,15,15,"2020-21",65.8536585365854
"5827",2021-04-06,"Milwaukee Bucks",121,"Golden State Warriors",122,0,1,1,1,"2020-21",67.5675675675676
"5828",2021-04-06,"Portland Trail Blazers",116,"Los Angeles Clippers",133,0,1,17,17,"2020-21",67.3913043478261
"5829",2021-04-07,"Minnesota Timberwolves",137,"Indiana Pacers",141,0,1,4,4,"2020-21",37.8378378378378
"5830",2021-04-07,"Washington Wizards",131,"Orlando Magic",116,3991,0,-15,15,"2020-21",30.5555555555556
"5831",2021-04-07,"New York Knicks",99,"Boston Celtics",101,2298,1,2,2,"2020-21",58.974358974359
"5832",2021-04-07,"New Orleans Pelicans",111,"Brooklyn Nets",139,1773,1,28,28,"2020-21",79.0697674418605
"5833",2021-04-07,"Memphis Grizzlies",131,"Atlanta Hawks",113,2774,0,-18,18,"2020-21",65.9090909090909
"5834",2021-04-07,"Dallas Mavericks",93,"Houston Rockets",102,3399,1,9,9,"2020-21",25
"5835",2021-04-07,"Charlotte Hornets",113,"Oklahoma City Thunder",102,0,0,-11,11,"2020-21",27.7777777777778
"5836",2021-04-07,"San Antonio Spurs",96,"Denver Nuggets",106,3715,1,10,10,"2020-21",65.8536585365854
"5837",2021-04-07,"Utah Jazz",113,"Phoenix Suns",117,5110,1,4,4,"2020-21",74.468085106383
"5838",2021-04-08,"Los Angeles Lakers",104,"Miami Heat",110,0,1,6,6,"2020-21",55.2631578947368
"5839",2021-04-08,"Chicago Bulls",122,"Toronto Raptors",113,0,0,-9,9,"2020-21",44.4444444444444
"5840",2021-04-08,"Cleveland Cavaliers",129,"Oklahoma City Thunder",102,0,0,-27,27,"2020-21",27.7777777777778
"5841",2021-04-08,"Milwaukee Bucks",101,"Dallas Mavericks",116,4190,1,15,15,"2020-21",53.8461538461538
"5842",2021-04-08,"Phoenix Suns",103,"Los Angeles Clippers",113,0,1,10,10,"2020-21",67.3913043478261
"5843",2021-04-08,"Detroit Pistons",113,"Sacramento Kings",101,0,0,-12,12,"2020-21",44.4444444444444
"5844",2021-04-08,"Portland Trail Blazers",103,"Utah Jazz",122,5546,1,19,19,"2020-21",83.3333333333333
"5845",2021-04-09,"Indiana Pacers",111,"Orlando Magic",106,3777,0,-5,5,"2020-21",30.5555555555556
"5846",2021-04-09,"Minnesota Timberwolves",136,"Boston Celtics",145,2298,1,9,9,"2020-21",58.974358974359
"5847",2021-04-09,"Memphis Grizzlies",129,"New York Knicks",133,1912,1,4,4,"2020-21",66.6666666666667
"5848",2021-04-09,"Chicago Bulls",108,"Atlanta Hawks",120,996,1,12,12,"2020-21",65.9090909090909
"5849",2021-04-09,"Philadelphia 76ers",94,"New Orleans Pelicans",101,3700,1,7,7,"2020-21",50
"5850",2021-04-09,"San Antonio Spurs",119,"Denver Nuggets",121,3750,1,2,2,"2020-21",65.8536585365854
"5851",2021-04-09,"Charlotte Hornets",127,"Milwaukee Bucks",119,3280,0,-8,8,"2020-21",76.5957446808511
"5852",2021-04-09,"Washington Wizards",110,"Golden State Warriors",107,0,0,-3,3,"2020-21",67.5675675675676
"5853",2021-04-09,"Houston Rockets",109,"Los Angeles Clippers",126,0,1,17,17,"2020-21",67.3913043478261
"5854",2021-04-10,"Toronto Raptors",135,"Cleveland Cavaliers",115,4148,0,-20,20,"2020-21",36.1111111111111
"5855",2021-04-10,"Los Angeles Lakers",126,"Brooklyn Nets",101,1773,0,-25,25,"2020-21",79.0697674418605
"5856",2021-04-10,"Philadelphia 76ers",117,"Oklahoma City Thunder",93,0,0,-24,24,"2020-21",27.7777777777778
"5857",2021-04-10,"Sacramento Kings",112,"Utah Jazz",128,5546,1,16,16,"2020-21",83.3333333333333
"5858",2021-04-10,"Houston Rockets",109,"Golden State Warriors",125,0,1,16,16,"2020-21",67.5675675675676
"5859",2021-04-10,"Washington Wizards",106,"Phoenix Suns",134,5028,1,28,28,"2020-21",74.468085106383
"5860",2021-04-10,"Detroit Pistons",103,"Portland Trail Blazers",118,0,1,15,15,"2020-21",53.8461538461538
"5861",2021-04-11,"Atlanta Hawks",105,"Charlotte Hornets",101,4148,0,-4,4,"2020-21",50
"5862",2021-04-11,"Boston Celtics",105,"Denver Nuggets",87,4032,0,-18,18,"2020-21",65.8536585365854
"5863",2021-04-11,"New Orleans Pelicans",116,"Cleveland Cavaliers",109,4148,0,-7,7,"2020-21",36.1111111111111
"5864",2021-04-11,"Milwaukee Bucks",124,"Orlando Magic",87,3316,0,-37,37,"2020-21",30.5555555555556
"5865",2021-04-11,"San Antonio Spurs",119,"Dallas Mavericks",117,4054,0,-2,2,"2020-21",53.8461538461538
"5866",2021-04-11,"Indiana Pacers",132,"Memphis Grizzlies",125,2341,0,-7,7,"2020-21",48.7179487179487
"5867",2021-04-11,"Chicago Bulls",117,"Minnesota Timberwolves",121,1436,1,4,4,"2020-21",36.1111111111111
"5868",2021-04-11,"Toronto Raptors",96,"New York Knicks",102,1833,1,6,6,"2020-21",66.6666666666667
"5869",2021-04-11,"Detroit Pistons",124,"Los Angeles Clippers",131,0,1,7,7,"2020-21",67.3913043478261
"5870",2021-04-11,"Miami Heat",107,"Portland Trail Blazers",98,0,0,-9,9,"2020-21",53.8461538461538
"5871",2021-04-12,"Philadelphia 76ers",113,"Dallas Mavericks",95,4016,0,-18,18,"2020-21",53.8461538461538
"5872",2021-04-12,"Los Angeles Lakers",96,"New York Knicks",111,1981,1,15,15,"2020-21",66.6666666666667
"5873",2021-04-12,"San Antonio Spurs",120,"Orlando Magic",97,3107,0,-23,23,"2020-21",30.5555555555556
"5874",2021-04-12,"Chicago Bulls",90,"Memphis Grizzlies",101,2194,1,11,11,"2020-21",48.7179487179487
"5875",2021-04-12,"Sacramento Kings",110,"New Orleans Pelicans",117,3700,1,7,7,"2020-21",50
"5876",2021-04-12,"Washington Wizards",125,"Utah Jazz",121,5546,0,-4,4,"2020-21",83.3333333333333
"5877",2021-04-12,"Denver Nuggets",107,"Golden State Warriors",116,0,1,9,9,"2020-21",67.5675675675676
"5878",2021-04-12,"Houston Rockets",120,"Phoenix Suns",126,4145,1,6,6,"2020-21",74.468085106383
"5879",2021-04-13,"Brooklyn Nets",127,"Minnesota Timberwolves",97,0,0,-30,30,"2020-21",36.1111111111111
"5880",2021-04-13,"Los Angeles Clippers",126,"Indiana Pacers",115,0,0,-11,11,"2020-21",37.8378378378378
"5881",2021-04-13,"Atlanta Hawks",108,"Toronto Raptors",103,1427,0,-5,5,"2020-21",44.4444444444444
"5882",2021-04-13,"Los Angeles Lakers",101,"Charlotte Hornets",93,3676,0,-8,8,"2020-21",50
"5883",2021-04-13,"Oklahoma City Thunder",96,"Utah Jazz",106,5546,1,10,10,"2020-21",83.3333333333333
"5884",2021-04-13,"Miami Heat",86,"Phoenix Suns",106,5024,1,20,20,"2020-21",74.468085106383
"5885",2021-04-13,"Boston Celtics",116,"Portland Trail Blazers",115,0,0,-1,1,"2020-21",53.8461538461538
"5886",2021-04-14,"Milwaukee Bucks",130,"Minnesota Timberwolves",105,0,0,-25,25,"2020-21",36.1111111111111
"5887",2021-04-14,"Cleveland Cavaliers",103,"Charlotte Hornets",90,2955,0,-13,13,"2020-21",50
"5888",2021-04-14,"Brooklyn Nets",117,"Philadelphia 76ers",123,4094,1,6,6,"2020-21",76.7441860465116
"5889",2021-04-14,"San Antonio Spurs",112,"Toronto Raptors",117,1184,1,5,5,"2020-21",44.4444444444444
"5890",2021-04-14,"Orlando Magic",115,"Chicago Bulls",106,0,0,-9,9,"2020-21",41.6666666666667
"5891",2021-04-14,"Los Angeles Clippers",100,"Detroit Pistons",98,750,0,-2,2,"2020-21",36.1111111111111
"5892",2021-04-14,"New York Knicks",116,"New Orleans Pelicans",106,3700,0,-10,10,"2020-21",50
"5893",2021-04-14,"Indiana Pacers",132,"Houston Rockets",124,3293,0,-8,8,"2020-21",25
"5894",2021-04-14,"Golden State Warriors",147,"Oklahoma City Thunder",109,0,0,-38,38,"2020-21",27.7777777777778
"5895",2021-04-14,"Dallas Mavericks",114,"Memphis Grizzlies",113,2141,0,-1,1,"2020-21",48.7179487179487
"5896",2021-04-14,"Miami Heat",106,"Denver Nuggets",123,4017,1,17,17,"2020-21",65.8536585365854
"5897",2021-04-14,"Washington Wizards",123,"Sacramento Kings",111,0,0,-12,12,"2020-21",44.4444444444444
"5898",2021-04-15,"Milwaukee Bucks",120,"Atlanta Hawks",109,0,0,-11,11,"2020-21",65.9090909090909
"5899",2021-04-15,"Golden State Warriors",119,"Cleveland Cavaliers",101,4148,0,-18,18,"2020-21",36.1111111111111
"5900",2021-04-15,"Boston Celtics",121,"Los Angeles Lakers",113,1915,0,-8,8,"2020-21",57.5
"5901",2021-04-15,"Sacramento Kings",114,"Phoenix Suns",122,4568,1,8,8,"2020-21",74.468085106383
"5902",2021-04-16,"Indiana Pacers",111,"Utah Jazz",119,5546,1,8,8,"2020-21",83.3333333333333
"5903",2021-04-16,"Oklahoma City Thunder",104,"Detroit Pistons",110,750,1,6,6,"2020-21",36.1111111111111
"5904",2021-04-16,"Los Angeles Clippers",103,"Philadelphia 76ers",106,4094,1,3,3,"2020-21",76.7441860465116
"5905",2021-04-16,"New Orleans Pelicans",115,"Washington Wizards",117,0,1,2,2,"2020-21",53.8461538461538
"5906",2021-04-16,"Charlotte Hornets",115,"Brooklyn Nets",130,1773,1,15,15,"2020-21",79.0697674418605
"5907",2021-04-16,"Orlando Magic",102,"Toronto Raptors",113,0,1,11,11,"2020-21",44.4444444444444
"5908",2021-04-16,"Memphis Grizzlies",126,"Chicago Bulls",115,0,0,-11,11,"2020-21",41.6666666666667
"5909",2021-04-16,"Denver Nuggets",128,"Houston Rockets",99,3342,0,-29,29,"2020-21",25
"5910",2021-04-16,"Miami Heat",111,"Minnesota Timberwolves",119,1638,1,8,8,"2020-21",36.1111111111111
"5911",2021-04-16,"Portland Trail Blazers",107,"San Antonio Spurs",106,4303,0,-1,1,"2020-21",38.8888888888889
"5912",2021-04-16,"New York Knicks",117,"Dallas Mavericks",109,4246,0,-8,8,"2020-21",53.8461538461538
"5913",2021-04-17,"Utah Jazz",115,"Los Angeles Lakers",127,1710,1,12,12,"2020-21",57.5
"5914",2021-04-17,"Cleveland Cavaliers",96,"Chicago Bulls",106,0,1,10,10,"2020-21",41.6666666666667
"5915",2021-04-17,"Detroit Pistons",100,"Washington Wizards",121,0,1,21,21,"2020-21",53.8461538461538
"5916",2021-04-17,"Golden State Warriors",114,"Boston Celtics",119,2298,1,5,5,"2020-21",58.974358974359
"5917",2021-04-17,"Memphis Grizzlies",128,"Milwaukee Bucks",115,3280,0,-13,13,"2020-21",76.5957446808511
"5918",2021-04-17,"San Antonio Spurs",111,"Phoenix Suns",85,5078,0,-26,26,"2020-21",74.468085106383
"5919",2021-04-18,"Indiana Pacers",117,"Atlanta Hawks",129,0,1,12,12,"2020-21",65.9090909090909
"5920",2021-04-18,"New Orleans Pelicans",112,"New York Knicks",122,1981,1,10,10,"2020-21",66.6666666666667
"5921",2021-04-18,"Brooklyn Nets",107,"Miami Heat",109,0,1,2,2,"2020-21",55.2631578947368
"5922",2021-04-18,"Portland Trail Blazers",101,"Charlotte Hornets",109,3880,1,8,8,"2020-21",50
"5923",2021-04-18,"Houston Rockets",114,"Orlando Magic",110,3772,0,-4,4,"2020-21",30.5555555555556
"5924",2021-04-18,"Oklahoma City Thunder",106,"Toronto Raptors",112,0,1,6,6,"2020-21",44.4444444444444
"5925",2021-04-18,"Sacramento Kings",121,"Dallas Mavericks",107,4193,0,-14,14,"2020-21",53.8461538461538
"5926",2021-04-18,"Minnesota Timberwolves",105,"Los Angeles Clippers",124,1734,1,19,19,"2020-21",67.3913043478261
"5927",2021-04-19,"Cleveland Cavaliers",105,"Detroit Pistons",109,750,1,4,4,"2020-21",36.1111111111111
"5928",2021-04-19,"Chicago Bulls",102,"Boston Celtics",96,0,0,-6,6,"2020-21",58.974358974359
"5929",2021-04-19,"Golden State Warriors",107,"Philadelphia 76ers",96,4094,0,-11,11,"2020-21",76.7441860465116
"5930",2021-04-19,"San Antonio Spurs",109,"Indiana Pacers",94,0,0,-15,15,"2020-21",37.8378378378378
"5931",2021-04-19,"Houston Rockets",91,"Miami Heat",113,0,1,22,22,"2020-21",55.2631578947368
"5932",2021-04-19,"Phoenix Suns",128,"Milwaukee Bucks",127,3280,0,-1,1,"2020-21",76.5957446808511
"5933",2021-04-19,"Oklahoma City Thunder",107,"Washington Wizards",119,0,1,12,12,"2020-21",53.8461538461538
"5934",2021-04-19,"Memphis Grizzlies",137,"Denver Nuggets",139,4005,1,2,2,"2020-21",65.8536585365854
"5935",2021-04-19,"Utah Jazz",111,"Los Angeles Lakers",97,1709,0,-14,14,"2020-21",57.5
"5936",2021-04-20,"Orlando Magic",96,"Atlanta Hawks",112,2219,1,16,16,"2020-21",65.9090909090909
"5937",2021-04-20,"Brooklyn Nets",134,"New Orleans Pelicans",129,3700,0,-5,5,"2020-21",50
"5938",2021-04-20,"Charlotte Hornets",97,"New York Knicks",109,1753,1,12,12,"2020-21",66.6666666666667
"5939",2021-04-20,"Los Angeles Clippers",113,"Portland Trail Blazers",112,0,0,-1,1,"2020-21",53.8461538461538
"5940",2021-04-20,"Minnesota Timberwolves",134,"Sacramento Kings",120,0,0,-14,14,"2020-21",44.4444444444444
"5941",2021-04-21,"Chicago Bulls",105,"Cleveland Cavaliers",121,0,1,16,16,"2020-21",36.1111111111111
"5942",2021-04-21,"Oklahoma City Thunder",116,"Indiana Pacers",122,0,1,6,6,"2020-21",37.8378378378378
"5943",2021-04-21,"Phoenix Suns",116,"Philadelphia 76ers",113,4094,0,-3,3,"2020-21",76.7441860465116
"5944",2021-04-21,"Brooklyn Nets",103,"Toronto Raptors",114,0,1,11,11,"2020-21",44.4444444444444
"5945",2021-04-21,"Golden State Warriors",114,"Washington Wizards",118,2133,1,4,4,"2020-21",53.8461538461538
"5946",2021-04-21,"Utah Jazz",112,"Houston Rockets",89,3253,0,-23,23,"2020-21",25
"5947",2021-04-21,"Atlanta Hawks",127,"New York Knicks",137,1981,1,10,10,"2020-21",66.6666666666667
"5948",2021-04-21,"Detroit Pistons",117,"Dallas Mavericks",127,4043,1,10,10,"2020-21",53.8461538461538
"5949",2021-04-21,"Miami Heat",107,"San Antonio Spurs",87,4229,0,-20,20,"2020-21",38.8888888888889
"5950",2021-04-21,"Memphis Grizzlies",105,"Los Angeles Clippers",117,1782,1,12,12,"2020-21",67.3913043478261
"5951",2021-04-21,"Denver Nuggets",106,"Portland Trail Blazers",105,0,0,-1,1,"2020-21",53.8461538461538
"5952",2021-04-21,"Minnesota Timberwolves",125,"Sacramento Kings",128,0,1,3,3,"2020-21",44.4444444444444
"5953",2021-04-22,"Phoenix Suns",86,"Boston Celtics",99,2298,1,13,13,"2020-21",58.974358974359
"5954",2021-04-22,"Philadelphia 76ers",117,"Milwaukee Bucks",124,3280,1,7,7,"2020-21",76.5957446808511
"5955",2021-04-22,"New Orleans Pelicans",135,"Orlando Magic",100,3411,0,-35,35,"2020-21",30.5555555555556
"5956",2021-04-22,"Detroit Pistons",91,"San Antonio Spurs",106,3334,1,15,15,"2020-21",38.8888888888889
"5957",2021-04-22,"Charlotte Hornets",91,"Chicago Bulls",108,0,1,17,17,"2020-21",41.6666666666667
"5958",2021-04-22,"Los Angeles Lakers",110,"Dallas Mavericks",115,4443,1,5,5,"2020-21",53.8461538461538
"5959",2021-04-23,"Miami Heat",103,"Atlanta Hawks",118,2985,1,15,15,"2020-21",65.9090909090909
"5960",2021-04-23,"Boston Celtics",104,"Brooklyn Nets",109,1773,1,5,5,"2020-21",79.0697674418605
"5961",2021-04-23,"Cleveland Cavaliers",102,"Charlotte Hornets",108,4060,1,6,6,"2020-21",50
"5962",2021-04-23,"Los Angeles Clippers",109,"Houston Rockets",104,3313,0,-5,5,"2020-21",25
"5963",2021-04-23,"Washington Wizards",129,"Oklahoma City Thunder",109,0,0,-20,20,"2020-21",27.7777777777778
"5964",2021-04-23,"Denver Nuggets",97,"Golden State Warriors",118,1935,1,21,21,"2020-21",67.5675675675676
"5965",2021-04-23,"Memphis Grizzlies",130,"Portland Trail Blazers",128,0,0,-2,2,"2020-21",53.8461538461538
"5966",2021-04-24,"Toronto Raptors",103,"New York Knicks",120,1981,1,17,17,"2020-21",66.6666666666667
"5967",2021-04-24,"Philadelphia 76ers",94,"Milwaukee Bucks",132,3280,1,38,38,"2020-21",76.5957446808511
"5968",2021-04-24,"Detroit Pistons",109,"Indiana Pacers",115,0,1,6,6,"2020-21",37.8378378378378
"5969",2021-04-24,"Chicago Bulls",101,"Miami Heat",106,0,1,5,5,"2020-21",55.2631578947368
"5970",2021-04-24,"San Antonio Spurs",110,"New Orleans Pelicans",108,3700,0,-2,2,"2020-21",50
"5971",2021-04-24,"Los Angeles Lakers",93,"Dallas Mavericks",108,4561,1,15,15,"2020-21",53.8461538461538
"5972",2021-04-24,"Minnesota Timberwolves",101,"Utah Jazz",96,0,0,-5,5,"2020-21",83.3333333333333
"5973",2021-04-24,"Houston Rockets",116,"Denver Nuggets",129,4035,1,13,13,"2020-21",65.8536585365854
"5974",2021-04-25,"Boston Celtics",104,"Charlotte Hornets",125,4493,1,21,21,"2020-21",50
"5975",2021-04-25,"Phoenix Suns",119,"Brooklyn Nets",128,1773,1,9,9,"2020-21",79.0697674418605
"5976",2021-04-25,"Memphis Grizzlies",120,"Portland Trail Blazers",113,0,0,-7,7,"2020-21",53.8461538461538
"5977",2021-04-25,"Cleveland Cavaliers",110,"Washington Wizards",119,2133,1,9,9,"2020-21",53.8461538461538
"5978",2021-04-25,"Milwaukee Bucks",104,"Atlanta Hawks",111,3010,1,7,7,"2020-21",65.9090909090909
"5979",2021-04-25,"Indiana Pacers",131,"Orlando Magic",112,3519,0,-19,19,"2020-21",30.5555555555556
"5980",2021-04-25,"Sacramento Kings",113,"Golden State Warriors",117,3252,1,4,4,"2020-21",67.5675675675676
"5981",2021-04-26,"Atlanta Hawks",86,"Detroit Pistons",100,750,1,14,14,"2020-21",36.1111111111111
"5982",2021-04-26,"Los Angeles Lakers",114,"Orlando Magic",103,4099,0,-11,11,"2020-21",30.5555555555556
"5983",2021-04-26,"Oklahoma City Thunder",90,"Philadelphia 76ers",121,4094,1,31,31,"2020-21",76.7441860465116
"5984",2021-04-26,"San Antonio Spurs",146,"Washington Wizards",143,2133,0,-3,3,"2020-21",53.8461538461538
"5985",2021-04-26,"Phoenix Suns",118,"New York Knicks",110,1981,0,-8,8,"2020-21",66.6666666666667
"5986",2021-04-26,"Cleveland Cavaliers",96,"Toronto Raptors",112,1626,1,16,16,"2020-21",44.4444444444444
"5987",2021-04-26,"Chicago Bulls",110,"Miami Heat",102,0,0,-8,8,"2020-21",55.2631578947368
"5988",2021-04-26,"Utah Jazz",104,"Minnesota Timberwolves",105,1638,1,1,1,"2020-21",36.1111111111111
"5989",2021-04-26,"Los Angeles Clippers",103,"New Orleans Pelicans",120,3700,1,17,17,"2020-21",50
"5990",2021-04-26,"Memphis Grizzlies",96,"Denver Nuggets",120,3823,1,24,24,"2020-21",65.8536585365854
"5991",2021-04-26,"Dallas Mavericks",106,"Sacramento Kings",113,0,1,7,7,"2020-21",44.4444444444444
"5992",2021-04-27,"Oklahoma City Thunder",119,"Boston Celtics",115,2298,0,-4,4,"2020-21",58.974358974359
"5993",2021-04-27,"Milwaukee Bucks",114,"Charlotte Hornets",104,3240,0,-10,10,"2020-21",50
"5994",2021-04-27,"Portland Trail Blazers",133,"Indiana Pacers",112,0,0,-21,21,"2020-21",37.8378378378378
"5995",2021-04-27,"Brooklyn Nets",116,"Toronto Raptors",103,0,0,-13,13,"2020-21",44.4444444444444
"5996",2021-04-27,"Minnesota Timberwolves",114,"Houston Rockets",107,3225,0,-7,7,"2020-21",25
"5997",2021-04-27,"Dallas Mavericks",133,"Golden State Warriors",103,3613,0,-30,30,"2020-21",67.5675675675676
"5998",2021-04-28,"Orlando Magic",109,"Cleveland Cavaliers",104,4148,0,-5,5,"2020-21",36.1111111111111
"5999",2021-04-28,"Atlanta Hawks",83,"Philadelphia 76ers",127,4094,1,44,44,"2020-21",76.7441860465116
"6000",2021-04-28,"Charlotte Hornets",111,"Boston Celtics",120,2298,1,9,9,"2020-21",58.974358974359
"6001",2021-04-28,"Chicago Bulls",94,"New York Knicks",113,1981,1,19,19,"2020-21",66.6666666666667
"6002",2021-04-28,"Los Angeles Lakers",107,"Washington Wizards",116,2133,1,9,9,"2020-21",53.8461538461538
"6003",2021-04-28,"San Antonio Spurs",111,"Miami Heat",116,0,1,5,5,"2020-21",55.2631578947368
"6004",2021-04-28,"New Orleans Pelicans",112,"Denver Nuggets",114,4022,1,2,2,"2020-21",65.8536585365854
"6005",2021-04-28,"Portland Trail Blazers",130,"Memphis Grizzlies",109,3427,0,-21,21,"2020-21",48.7179487179487
"6006",2021-04-28,"Los Angeles Clippers",101,"Phoenix Suns",109,5917,1,8,8,"2020-21",74.468085106383
"6007",2021-04-28,"Utah Jazz",154,"Sacramento Kings",105,0,0,-49,49,"2020-21",44.4444444444444
"6008",2021-04-29,"Dallas Mavericks",115,"Detroit Pistons",105,750,0,-10,10,"2020-21",36.1111111111111
"6009",2021-04-29,"Brooklyn Nets",130,"Indiana Pacers",113,0,0,-17,17,"2020-21",37.8378378378378
"6010",2021-04-29,"Milwaukee Bucks",136,"Houston Rockets",143,3232,1,7,7,"2020-21",25
"6011",2021-04-29,"Golden State Warriors",114,"Minnesota Timberwolves",126,1638,1,12,12,"2020-21",36.1111111111111
"6012",2021-04-29,"Toronto Raptors",111,"Denver Nuggets",121,4025,1,10,10,"2020-21",65.8536585365854
"6013",2021-04-29,"New Orleans Pelicans",109,"Oklahoma City Thunder",95,0,0,-14,14,"2020-21",27.7777777777778
"6014",2021-04-30,"Atlanta Hawks",104,"Philadelphia 76ers",126,4094,1,22,22,"2020-21",76.7441860465116
"6015",2021-04-30,"San Antonio Spurs",140,"Boston Celtics",143,2298,1,3,3,"2020-21",58.974358974359
"6016",2021-04-30,"Washington Wizards",122,"Cleveland Cavaliers",93,4148,0,-29,29,"2020-21",36.1111111111111
"6017",2021-04-30,"Portland Trail Blazers",128,"Brooklyn Nets",109,1773,0,-19,19,"2020-21",79.0697674418605
"6018",2021-04-30,"Orlando Magic",75,"Memphis Grizzlies",92,2850,1,17,17,"2020-21",48.7179487179487
"6019",2021-04-30,"Milwaukee Bucks",108,"Chicago Bulls",98,0,0,-10,10,"2020-21",41.6666666666667
"6020",2021-04-30,"Utah Jazz",100,"Phoenix Suns",121,6065,1,21,21,"2020-21",74.468085106383
"6021",2021-04-30,"Sacramento Kings",110,"Los Angeles Lakers",106,2691,0,-4,4,"2020-21",57.5
"6022",2021-05-01,"Detroit Pistons",94,"Charlotte Hornets",107,3766,1,13,13,"2020-21",50
"6023",2021-05-01,"Golden State Warriors",113,"Houston Rockets",87,3702,0,-26,26,"2020-21",25
"6024",2021-05-01,"Chicago Bulls",97,"Atlanta Hawks",108,3053,1,11,11,"2020-21",65.9090909090909
"6025",2021-05-01,"Miami Heat",124,"Cleveland Cavaliers",107,4148,0,-17,17,"2020-21",36.1111111111111
"6026",2021-05-01,"New Orleans Pelicans",140,"Minnesota Timberwolves",136,1638,0,-4,4,"2020-21",36.1111111111111
"6027",2021-05-01,"Indiana Pacers",152,"Oklahoma City Thunder",95,0,0,-57,57,"2020-21",27.7777777777778
"6028",2021-05-01,"Memphis Grizzlies",111,"Orlando Magic",112,3924,1,1,1,"2020-21",30.5555555555556
"6029",2021-05-01,"Washington Wizards",124,"Dallas Mavericks",125,4351,1,1,1,"2020-21",53.8461538461538
"6030",2021-05-01,"Denver Nuggets",110,"Los Angeles Clippers",104,2818,0,-6,6,"2020-21",67.3913043478261
"6031",2021-05-01,"Toronto Raptors",102,"Utah Jazz",106,6506,1,4,4,"2020-21",83.3333333333333
"6032",2021-05-02,"Brooklyn Nets",114,"Milwaukee Bucks",117,3280,1,3,3,"2020-21",76.5957446808511
"6033",2021-05-02,"Portland Trail Blazers",129,"Boston Celtics",119,0,0,-10,10,"2020-21",58.974358974359
"6034",2021-05-02,"Miami Heat",121,"Charlotte Hornets",111,4095,0,-10,10,"2020-21",50
"6035",2021-05-02,"Sacramento Kings",111,"Dallas Mavericks",99,4268,0,-12,12,"2020-21",53.8461538461538
"6036",2021-05-02,"New York Knicks",122,"Houston Rockets",97,3431,0,-25,25,"2020-21",25
"6037",2021-05-02,"Phoenix Suns",123,"Oklahoma City Thunder",120,0,0,-3,3,"2020-21",27.7777777777778
"6038",2021-05-02,"Philadelphia 76ers",113,"San Antonio Spurs",111,3978,0,-2,2,"2020-21",38.8888888888889
"6039",2021-05-02,"Toronto Raptors",121,"Los Angeles Lakers",114,2053,0,-7,7,"2020-21",57.5
"6040",2021-05-03,"Orlando Magic",119,"Detroit Pistons",112,750,0,-7,7,"2020-21",36.1111111111111
"6041",2021-05-03,"Indiana Pacers",141,"Washington Wizards",154,0,1,13,13,"2020-21",53.8461538461538
"6042",2021-05-03,"Golden State Warriors",123,"New Orleans Pelicans",108,3700,0,-15,15,"2020-21",50
"6043",2021-05-03,"Portland Trail Blazers",114,"Atlanta Hawks",123,3091,1,9,9,"2020-21",65.9090909090909
"6044",2021-05-03,"Philadelphia 76ers",106,"Chicago Bulls",94,0,0,-12,12,"2020-21",41.6666666666667
"6045",2021-05-03,"New York Knicks",118,"Memphis Grizzlies",104,2789,0,-14,14,"2020-21",48.7179487179487
"6046",2021-05-03,"Denver Nuggets",89,"Los Angeles Lakers",93,2454,1,4,4,"2020-21",57.5
"6047",2021-05-03,"San Antonio Spurs",99,"Utah Jazz",110,6506,1,11,11,"2020-21",83.3333333333333
"6048",2021-05-04,"Phoenix Suns",134,"Cleveland Cavaliers",118,4148,0,-16,16,"2020-21",36.1111111111111
"6049",2021-05-04,"Charlotte Hornets",102,"Detroit Pistons",99,750,0,-3,3,"2020-21",36.1111111111111
"6050",2021-05-04,"Brooklyn Nets",118,"Milwaukee Bucks",124,3280,1,6,6,"2020-21",76.5957446808511
"6051",2021-05-04,"Dallas Mavericks",127,"Miami Heat",113,0,0,-14,14,"2020-21",55.2631578947368
"6052",2021-05-04,"Golden State Warriors",103,"New Orleans Pelicans",108,3700,1,5,5,"2020-21",50
"6053",2021-05-04,"Sacramento Kings",103,"Oklahoma City Thunder",99,0,0,-4,4,"2020-21",27.7777777777778
"6054",2021-05-04,"Toronto Raptors",100,"Los Angeles Clippers",105,1714,1,5,5,"2020-21",67.3913043478261
"6055",2021-05-05,"Boston Celtics",132,"Orlando Magic",96,0,0,-36,36,"2020-21",30.5555555555556
"6056",2021-05-05,"Portland Trail Blazers",141,"Cleveland Cavaliers",105,4148,0,-36,36,"2020-21",36.1111111111111
"6057",2021-05-05,"Phoenix Suns",103,"Atlanta Hawks",135,3205,1,32,32,"2020-21",65.9090909090909
"6058",2021-05-05,"Philadelphia 76ers",135,"Houston Rockets",115,3583,0,-20,20,"2020-21",25
"6059",2021-05-05,"Sacramento Kings",104,"Indiana Pacers",93,0,0,-11,11,"2020-21",37.8378378378378
"6060",2021-05-05,"Washington Wizards",134,"Milwaukee Bucks",135,3280,1,1,1,"2020-21",76.5957446808511
"6061",2021-05-05,"Memphis Grizzlies",139,"Minnesota Timberwolves",135,1436,0,-4,4,"2020-21",36.1111111111111
"6062",2021-05-05,"New York Knicks",97,"Denver Nuggets",113,4038,1,16,16,"2020-21",65.8536585365854
"6063",2021-05-05,"San Antonio Spurs",94,"Utah Jazz",126,6506,1,32,32,"2020-21",83.3333333333333
"6064",2021-05-06,"Chicago Bulls",120,"Charlotte Hornets",99,3769,0,-21,21,"2020-21",50
"6065",2021-05-06,"Brooklyn Nets",109,"Dallas Mavericks",113,4602,1,4,4,"2020-21",53.8461538461538
"6066",2021-05-06,"Washington Wizards",131,"Toronto Raptors",129,2494,0,-2,2,"2020-21",44.4444444444444
"6067",2021-05-06,"Memphis Grizzlies",97,"Detroit Pistons",111,750,1,14,14,"2020-21",36.1111111111111
"6068",2021-05-06,"Atlanta Hawks",126,"Indiana Pacers",133,0,1,7,7,"2020-21",37.8378378378378
"6069",2021-05-06,"Oklahoma City Thunder",97,"Golden State Warriors",118,3621,1,21,21,"2020-21",67.5675675675676
"6070",2021-05-06,"Los Angeles Lakers",94,"Los Angeles Clippers",118,3275,1,24,24,"2020-21",67.3913043478261
"6071",2021-05-07,"New Orleans Pelicans",107,"Philadelphia 76ers",109,5119,1,2,2,"2020-21",76.7441860465116
"6072",2021-05-07,"Boston Celtics",99,"Chicago Bulls",121,3399,1,22,22,"2020-21",41.6666666666667
"6073",2021-05-07,"Orlando Magic",112,"Charlotte Hornets",122,3751,1,10,10,"2020-21",50
"6074",2021-05-07,"Minnesota Timberwolves",112,"Miami Heat",121,0,1,9,9,"2020-21",55.2631578947368
"6075",2021-05-07,"Houston Rockets",133,"Milwaukee Bucks",141,3280,1,8,8,"2020-21",76.5957446808511
"6076",2021-05-07,"Cleveland Cavaliers",90,"Dallas Mavericks",110,4220,1,20,20,"2020-21",53.8461538461538
"6077",2021-05-07,"Denver Nuggets",120,"Utah Jazz",127,6506,1,7,7,"2020-21",83.3333333333333
"6078",2021-05-07,"New York Knicks",105,"Phoenix Suns",128,8063,1,23,23,"2020-21",74.468085106383
"6079",2021-05-07,"Los Angeles Lakers",101,"Portland Trail Blazers",106,0,1,5,5,"2020-21",53.8461538461538
"6080",2021-05-07,"San Antonio Spurs",113,"Sacramento Kings",104,0,0,-9,9,"2020-21",44.4444444444444
"6081",2021-05-08,"Washington Wizards",133,"Indiana Pacers",132,0,0,-1,1,"2020-21",37.8378378378378
"6082",2021-05-08,"Detroit Pistons",104,"Philadelphia 76ers",118,5119,1,14,14,"2020-21",76.7441860465116
"6083",2021-05-08,"Memphis Grizzlies",109,"Toronto Raptors",99,0,0,-10,10,"2020-21",44.4444444444444
"6084",2021-05-08,"Brooklyn Nets",125,"Denver Nuggets",119,4044,0,-6,6,"2020-21",65.8536585365854
"6085",2021-05-08,"Oklahoma City Thunder",97,"Golden State Warriors",136,4155,1,39,39,"2020-21",67.5675675675676
"6086",2021-05-08,"San Antonio Spurs",102,"Portland Trail Blazers",124,1939,1,22,22,"2020-21",53.8461538461538
"6087",2021-05-08,"Houston Rockets",116,"Utah Jazz",124,6506,1,8,8,"2020-21",83.3333333333333
"6088",2021-05-09,"Miami Heat",130,"Boston Celtics",124,2298,0,-6,6,"2020-21",58.974358974359
"6089",2021-05-09,"New York Knicks",106,"Los Angeles Clippers",100,2578,0,-6,6,"2020-21",67.3913043478261
"6090",2021-05-09,"New Orleans Pelicans",112,"Charlotte Hornets",110,4196,0,-2,2,"2020-21",50
"6091",2021-05-09,"Dallas Mavericks",124,"Cleveland Cavaliers",97,4148,0,-27,27,"2020-21",36.1111111111111
"6092",2021-05-09,"Minnesota Timberwolves",128,"Orlando Magic",96,4086,0,-32,32,"2020-21",30.5555555555556
"6093",2021-05-09,"Chicago Bulls",108,"Detroit Pistons",96,750,0,-12,12,"2020-21",36.1111111111111
"6094",2021-05-09,"Phoenix Suns",110,"Los Angeles Lakers",123,3144,1,13,13,"2020-21",57.5
"6095",2021-05-09,"Oklahoma City Thunder",98,"Sacramento Kings",126,0,1,28,28,"2020-21",44.4444444444444
"6096",2021-05-10,"Washington Wizards",124,"Atlanta Hawks",125,3054,1,1,1,"2020-21",65.9090909090909
"6097",2021-05-10,"Indiana Pacers",111,"Cleveland Cavaliers",102,4148,0,-9,9,"2020-21",36.1111111111111
"6098",2021-05-10,"New Orleans Pelicans",110,"Memphis Grizzlies",115,2507,1,5,5,"2020-21",48.7179487179487
"6099",2021-05-10,"Milwaukee Bucks",125,"San Antonio Spurs",146,3992,1,21,21,"2020-21",38.8888888888889
"6100",2021-05-10,"Utah Jazz",116,"Golden State Warriors",119,4155,1,3,3,"2020-21",67.5675675675676
"6101",2021-05-10,"Houston Rockets",129,"Portland Trail Blazers",140,1939,1,11,11,"2020-21",53.8461538461538
"6102",2021-05-11,"Denver Nuggets",117,"Charlotte Hornets",112,3997,0,-5,5,"2020-21",50
"6103",2021-05-11,"Minnesota Timberwolves",119,"Detroit Pistons",100,750,0,-19,19,"2020-21",36.1111111111111
"6104",2021-05-11,"Miami Heat",129,"Boston Celtics",121,4789,0,-8,8,"2020-21",58.974358974359
"6105",2021-05-11,"Los Angeles Clippers",115,"Toronto Raptors",96,0,0,-19,19,"2020-21",44.4444444444444
"6106",2021-05-11,"Brooklyn Nets",115,"Chicago Bulls",107,3434,0,-8,8,"2020-21",41.6666666666667
"6107",2021-05-11,"Philadelphia 76ers",94,"Indiana Pacers",103,0,1,9,9,"2020-21",37.8378378378378
"6108",2021-05-11,"Dallas Mavericks",104,"Memphis Grizzlies",133,2684,1,29,29,"2020-21",48.7179487179487
"6109",2021-05-11,"Orlando Magic",102,"Milwaukee Bucks",114,3280,1,12,12,"2020-21",76.5957446808511
"6110",2021-05-11,"Phoenix Suns",116,"Golden State Warriors",122,4155,1,6,6,"2020-21",67.5675675675676
"6111",2021-05-11,"New York Knicks",99,"Los Angeles Lakers",101,3550,1,2,2,"2020-21",57.5
"6112",2021-05-11,"Oklahoma City Thunder",106,"Sacramento Kings",122,0,1,16,16,"2020-21",44.4444444444444
"6113",2021-05-12,"Washington Wizards",116,"Atlanta Hawks",120,3120,1,4,4,"2020-21",65.9090909090909
"6114",2021-05-12,"San Antonio Spurs",116,"Brooklyn Nets",128,1773,1,12,12,"2020-21",79.0697674418605
"6115",2021-05-12,"Boston Celtics",94,"Cleveland Cavaliers",102,4148,1,8,8,"2020-21",36.1111111111111
"6116",2021-05-12,"New Orleans Pelicans",107,"Dallas Mavericks",125,4373,1,18,18,"2020-21",53.8461538461538
"6117",2021-05-12,"Portland Trail Blazers",105,"Utah Jazz",98,6506,0,-7,7,"2020-21",83.3333333333333
"6118",2021-05-12,"Houston Rockets",122,"Los Angeles Lakers",124,4087,1,2,2,"2020-21",57.5
"6119",2021-05-13,"Los Angeles Clippers",113,"Charlotte Hornets",90,4442,0,-23,23,"2020-21",50
"6120",2021-05-13,"Milwaukee Bucks",142,"Indiana Pacers",133,0,0,-9,9,"2020-21",37.8378378378378
"6121",2021-05-13,"Orlando Magic",93,"Atlanta Hawks",116,2910,1,23,23,"2020-21",65.9090909090909
"6122",2021-05-13,"Philadelphia 76ers",94,"Miami Heat",106,0,1,12,12,"2020-21",55.2631578947368
"6123",2021-05-13,"San Antonio Spurs",98,"New York Knicks",102,1981,1,4,4,"2020-21",66.6666666666667
"6124",2021-05-13,"Toronto Raptors",102,"Chicago Bulls",114,3395,1,12,12,"2020-21",41.6666666666667
"6125",2021-05-13,"Sacramento Kings",110,"Memphis Grizzlies",116,2876,1,6,6,"2020-21",48.7179487179487
"6126",2021-05-13,"Denver Nuggets",114,"Minnesota Timberwolves",103,1638,0,-11,11,"2020-21",36.1111111111111
"6127",2021-05-13,"Portland Trail Blazers",117,"Phoenix Suns",118,8359,1,1,1,"2020-21",74.468085106383
"6128",2021-05-14,"Cleveland Cavaliers",105,"Washington Wizards",120,5333,1,15,15,"2020-21",53.8461538461538
"6129",2021-05-14,"Denver Nuggets",104,"Detroit Pistons",91,750,0,-13,13,"2020-21",36.1111111111111
"6130",2021-05-14,"Utah Jazz",109,"Oklahoma City Thunder",93,0,0,-16,16,"2020-21",27.7777777777778
"6131",2021-05-14,"Orlando Magic",97,"Philadelphia 76ers",122,5119,1,25,25,"2020-21",76.7441860465116
"6132",2021-05-14,"Toronto Raptors",110,"Dallas Mavericks",114,4493,1,4,4,"2020-21",53.8461538461538
"6133",2021-05-14,"Los Angeles Clippers",115,"Houston Rockets",122,3803,1,7,7,"2020-21",25
"6134",2021-05-14,"Sacramento Kings",106,"Memphis Grizzlies",107,3502,1,1,1,"2020-21",48.7179487179487
"6135",2021-05-14,"New Orleans Pelicans",122,"Golden State Warriors",125,4155,1,3,3,"2020-21",67.5675675675676
"6136",2021-05-15,"Chicago Bulls",91,"Brooklyn Nets",105,1773,1,14,14,"2020-21",79.0697674418605
"6137",2021-05-15,"Los Angeles Lakers",122,"Indiana Pacers",115,0,0,-7,7,"2020-21",37.8378378378378
"6138",2021-05-15,"Charlotte Hornets",109,"New York Knicks",118,1981,1,9,9,"2020-21",66.6666666666667
"6139",2021-05-15,"Boston Celtics",124,"Minnesota Timberwolves",108,1638,0,-16,16,"2020-21",36.1111111111111
"6140",2021-05-15,"Phoenix Suns",140,"San Antonio Spurs",103,4848,0,-37,37,"2020-21",38.8888888888889
"6141",2021-05-15,"Miami Heat",108,"Milwaukee Bucks",122,3280,1,14,14,"2020-21",76.5957446808511
"6142",2021-05-16,"Boston Celtics",92,"New York Knicks",96,1981,1,4,4,"2020-21",66.6666666666667
"6143",2021-05-16,"Indiana Pacers",125,"Toronto Raptors",113,0,0,-12,12,"2020-21",44.4444444444444
"6144",2021-05-16,"Charlotte Hornets",110,"Washington Wizards",115,5333,1,5,5,"2020-21",53.8461538461538
"6145",2021-05-16,"Phoenix Suns",123,"San Antonio Spurs",121,4738,0,-2,2,"2020-21",38.8888888888889
"6146",2021-05-16,"Memphis Grizzlies",101,"Golden State Warriors",113,4416,1,12,12,"2020-21",67.5675675675676
"6147",2021-05-16,"Houston Rockets",95,"Atlanta Hawks",124,3045,1,29,29,"2020-21",65.9090909090909
"6148",2021-05-16,"Cleveland Cavaliers",109,"Brooklyn Nets",123,1773,1,14,14,"2020-21",79.0697674418605
"6149",2021-05-16,"Orlando Magic",117,"Philadelphia 76ers",128,5119,1,11,11,"2020-21",76.7441860465116
"6150",2021-05-16,"Miami Heat",120,"Detroit Pistons",107,750,0,-13,13,"2020-21",36.1111111111111
"6151",2021-05-16,"Milwaukee Bucks",112,"Chicago Bulls",118,3427,1,6,6,"2020-21",41.6666666666667
"6152",2021-05-16,"Dallas Mavericks",121,"Minnesota Timberwolves",136,1638,1,15,15,"2020-21",36.1111111111111
"6153",2021-05-16,"Los Angeles Lakers",110,"New Orleans Pelicans",98,3700,0,-12,12,"2020-21",50
"6154",2021-05-16,"Los Angeles Clippers",112,"Oklahoma City Thunder",117,0,1,5,5,"2020-21",27.7777777777778
"6155",2021-05-16,"Denver Nuggets",116,"Portland Trail Blazers",132,1939,1,16,16,"2020-21",53.8461538461538
"6156",2021-05-16,"Utah Jazz",121,"Sacramento Kings",99,0,0,-22,22,"2020-21",44.4444444444444
"6157",2021-05-18,"Charlotte Hornets",117,"Indiana Pacers",144,0,1,27,27,"2020-21",37.8378378378378
"6158",2021-05-18,"Washington Wizards",100,"Boston Celtics",118,4789,1,18,18,"2020-21",58.974358974359
"6159",2021-05-19,"San Antonio Spurs",96,"Memphis Grizzlies",100,7019,1,4,4,"2020-21",48.7179487179487
"6160",2021-05-19,"Golden State Warriors",100,"Los Angeles Lakers",103,6022,1,3,3,"2020-21",57.5
"6161",2021-05-20,"Indiana Pacers",115,"Washington Wizards",142,0,1,27,27,"2020-21",53.8461538461538
"6162",2021-05-21,"Memphis Grizzlies",117,"Golden State Warriors",112,7505,0,-5,5,"2020-21",67.5675675675676
"6163",2021-05-22,"Miami Heat",107,"Milwaukee Bucks",109,9107,1,2,2,"2020-21",76.5957446808511
"6164",2021-05-22,"Dallas Mavericks",113,"Los Angeles Clippers",103,6117,0,-10,10,"2020-21",67.3913043478261
"6165",2021-05-22,"Boston Celtics",93,"Brooklyn Nets",104,14391,1,11,11,"2020-21",79.0697674418605
"6166",2021-05-22,"Portland Trail Blazers",123,"Denver Nuggets",109,7732,0,-14,14,"2020-21",65.8536585365854
"6167",2021-05-23,"Washington Wizards",118,"Philadelphia 76ers",125,11160,1,7,7,"2020-21",76.7441860465116
"6168",2021-05-23,"Los Angeles Lakers",90,"Phoenix Suns",99,11824,1,9,9,"2020-21",74.468085106383
"6169",2021-05-23,"Atlanta Hawks",107,"New York Knicks",105,15047,0,-2,2,"2020-21",66.6666666666667
"6170",2021-05-23,"Memphis Grizzlies",112,"Utah Jazz",109,13750,0,-3,3,"2020-21",83.3333333333333
"6171",2021-05-24,"Miami Heat",98,"Milwaukee Bucks",132,9107,1,34,34,"2020-21",76.5957446808511
"6172",2021-05-24,"Portland Trail Blazers",109,"Denver Nuggets",128,7727,1,19,19,"2020-21",65.8536585365854
"6173",2021-05-25,"Boston Celtics",108,"Brooklyn Nets",130,14774,1,22,22,"2020-21",79.0697674418605
"6174",2021-05-25,"Los Angeles Lakers",109,"Phoenix Suns",102,11919,0,-7,7,"2020-21",74.468085106383
"6175",2021-05-25,"Dallas Mavericks",127,"Los Angeles Clippers",121,6885,0,-6,6,"2020-21",67.3913043478261
"6176",2021-05-26,"Washington Wizards",95,"Philadelphia 76ers",120,11160,1,25,25,"2020-21",76.7441860465116
"6177",2021-05-26,"Atlanta Hawks",92,"New York Knicks",101,16254,1,9,9,"2020-21",66.6666666666667
"6178",2021-05-26,"Memphis Grizzlies",129,"Utah Jazz",141,14200,1,12,12,"2020-21",83.3333333333333
"6179",2021-05-27,"Milwaukee Bucks",113,"Miami Heat",84,17000,0,-29,29,"2020-21",55.2631578947368
"6180",2021-05-27,"Phoenix Suns",95,"Los Angeles Lakers",109,7825,1,14,14,"2020-21",57.5
"6181",2021-05-27,"Denver Nuggets",120,"Portland Trail Blazers",115,8050,0,-5,5,"2020-21",53.8461538461538
"6182",2021-05-28,"New York Knicks",94,"Atlanta Hawks",105,15743,1,11,11,"2020-21",65.9090909090909
"6183",2021-05-28,"Brooklyn Nets",119,"Boston Celtics",125,4789,1,6,6,"2020-21",58.974358974359
"6184",2021-05-28,"Los Angeles Clippers",118,"Dallas Mavericks",108,17705,0,-10,10,"2020-21",53.8461538461538
"6185",2021-05-29,"Milwaukee Bucks",120,"Miami Heat",103,17000,0,-17,17,"2020-21",55.2631578947368
"6186",2021-05-29,"Denver Nuggets",95,"Portland Trail Blazers",115,8050,1,20,20,"2020-21",53.8461538461538
"6187",2021-05-29,"Philadelphia 76ers",132,"Washington Wizards",103,0,0,-29,29,"2020-21",53.8461538461538
"6188",2021-05-29,"Utah Jazz",121,"Memphis Grizzlies",111,12185,0,-10,10,"2020-21",48.7179487179487
"6189",2021-05-30,"New York Knicks",96,"Atlanta Hawks",113,16458,1,17,17,"2020-21",65.9090909090909
"6190",2021-05-30,"Phoenix Suns",100,"Los Angeles Lakers",92,8025,0,-8,8,"2020-21",57.5
"6191",2021-05-30,"Brooklyn Nets",141,"Boston Celtics",126,17226,0,-15,15,"2020-21",58.974358974359
"6192",2021-05-30,"Los Angeles Clippers",106,"Dallas Mavericks",81,17761,0,-25,25,"2020-21",53.8461538461538
"6193",2021-05-31,"Philadelphia 76ers",114,"Washington Wizards",122,10665,1,8,8,"2020-21",53.8461538461538
"6194",2021-05-31,"Utah Jazz",120,"Memphis Grizzlies",113,12185,0,-7,7,"2020-21",48.7179487179487
"6195",2021-06-01,"Boston Celtics",109,"Brooklyn Nets",123,14993,1,14,14,"2020-21",79.0697674418605
"6196",2021-06-01,"Portland Trail Blazers",140,"Denver Nuggets",147,10463,1,7,7,"2020-21",65.8536585365854
"6197",2021-06-01,"Los Angeles Lakers",85,"Phoenix Suns",115,16163,1,30,30,"2020-21",74.468085106383
"6198",2021-06-02,"Washington Wizards",112,"Philadelphia 76ers",129,15523,1,17,17,"2020-21",76.7441860465116
"6199",2021-06-02,"Atlanta Hawks",103,"New York Knicks",89,16512,0,-14,14,"2020-21",66.6666666666667
"6200",2021-06-02,"Memphis Grizzlies",110,"Utah Jazz",126,14250,1,16,16,"2020-21",83.3333333333333
"6201",2021-06-02,"Dallas Mavericks",105,"Los Angeles Clippers",100,7428,0,-5,5,"2020-21",67.3913043478261
"6202",2021-06-03,"Denver Nuggets",126,"Portland Trail Blazers",115,10022,0,-11,11,"2020-21",53.8461538461538
"6203",2021-06-03,"Phoenix Suns",113,"Los Angeles Lakers",100,8550,0,-13,13,"2020-21",57.5
"6204",2021-06-04,"Los Angeles Clippers",104,"Dallas Mavericks",97,18324,0,-7,7,"2020-21",53.8461538461538
"6205",2021-06-05,"Milwaukee Bucks",107,"Brooklyn Nets",115,15750,1,8,8,"2020-21",79.0697674418605
"6206",2021-06-06,"Atlanta Hawks",128,"Philadelphia 76ers",124,18624,0,-4,4,"2020-21",76.7441860465116
"6207",2021-06-06,"Dallas Mavericks",111,"Los Angeles Clippers",126,7342,1,15,15,"2020-21",67.3913043478261
"6208",2021-06-07,"Milwaukee Bucks",86,"Brooklyn Nets",125,15776,1,39,39,"2020-21",79.0697674418605
"6209",2021-06-07,"Denver Nuggets",105,"Phoenix Suns",122,16219,1,17,17,"2020-21",74.468085106383
"6210",2021-06-08,"Atlanta Hawks",102,"Philadelphia 76ers",118,18624,1,16,16,"2020-21",76.7441860465116
"6211",2021-06-08,"Los Angeles Clippers",109,"Utah Jazz",112,18007,1,3,3,"2020-21",83.3333333333333
"6212",2021-06-09,"Denver Nuggets",98,"Phoenix Suns",123,16529,1,25,25,"2020-21",74.468085106383
"6213",2021-06-10,"Brooklyn Nets",83,"Milwaukee Bucks",86,16310,1,3,3,"2020-21",76.5957446808511
"6214",2021-06-10,"Los Angeles Clippers",111,"Utah Jazz",117,18007,1,6,6,"2020-21",83.3333333333333
"6215",2021-06-11,"Philadelphia 76ers",127,"Atlanta Hawks",111,16432,0,-16,16,"2020-21",65.9090909090909
"6216",2021-06-11,"Phoenix Suns",116,"Denver Nuggets",102,18277,0,-14,14,"2020-21",65.8536585365854
"6217",2021-06-12,"Utah Jazz",106,"Los Angeles Clippers",132,8185,1,26,26,"2020-21",67.3913043478261
"6218",2021-06-13,"Brooklyn Nets",96,"Milwaukee Bucks",107,16310,1,11,11,"2020-21",76.5957446808511
"6219",2021-06-13,"Phoenix Suns",125,"Denver Nuggets",118,18290,0,-7,7,"2020-21",65.8536585365854
"6220",2021-06-14,"Philadelphia 76ers",100,"Atlanta Hawks",103,16502,1,3,3,"2020-21",65.9090909090909
"6221",2021-06-14,"Utah Jazz",104,"Los Angeles Clippers",118,8474,1,14,14,"2020-21",67.3913043478261
"6222",2021-06-15,"Milwaukee Bucks",108,"Brooklyn Nets",114,16067,1,6,6,"2020-21",79.0697674418605
"6223",2021-06-16,"Atlanta Hawks",109,"Philadelphia 76ers",106,18624,0,-3,3,"2020-21",76.7441860465116
"6224",2021-06-16,"Los Angeles Clippers",119,"Utah Jazz",111,18007,0,-8,8,"2020-21",83.3333333333333
"6225",2021-06-17,"Brooklyn Nets",89,"Milwaukee Bucks",104,16310,1,15,15,"2020-21",76.5957446808511
"6226",2021-06-18,"Philadelphia 76ers",104,"Atlanta Hawks",99,16610,0,-5,5,"2020-21",65.9090909090909
"6227",2021-06-18,"Utah Jazz",119,"Los Angeles Clippers",131,17105,1,12,12,"2020-21",67.3913043478261
"6228",2021-06-19,"Milwaukee Bucks",115,"Brooklyn Nets",111,16287,0,-4,4,"2020-21",79.0697674418605
"6229",2021-06-20,"Los Angeles Clippers",114,"Phoenix Suns",120,16583,1,6,6,"2020-21",74.468085106383
"6230",2021-06-20,"Atlanta Hawks",103,"Philadelphia 76ers",96,18624,0,-7,7,"2020-21",76.7441860465116
"6231",2021-06-22,"Los Angeles Clippers",103,"Phoenix Suns",104,16645,1,1,1,"2020-21",74.468085106383
"6232",2021-06-23,"Atlanta Hawks",116,"Milwaukee Bucks",113,16310,0,-3,3,"2020-21",76.5957446808511
"6233",2021-06-24,"Phoenix Suns",92,"Los Angeles Clippers",106,17222,1,14,14,"2020-21",67.3913043478261
"6234",2021-06-25,"Atlanta Hawks",91,"Milwaukee Bucks",125,16422,1,34,34,"2020-21",76.5957446808511
"6235",2021-06-26,"Phoenix Suns",84,"Los Angeles Clippers",80,18222,0,-4,4,"2020-21",67.3913043478261
"6236",2021-06-27,"Milwaukee Bucks",113,"Atlanta Hawks",102,16650,0,-11,11,"2020-21",65.9090909090909
"6237",2021-06-28,"Los Angeles Clippers",116,"Phoenix Suns",102,16664,0,-14,14,"2020-21",74.468085106383
"6238",2021-06-29,"Milwaukee Bucks",88,"Atlanta Hawks",110,16478,1,22,22,"2020-21",65.9090909090909
"6239",2021-06-30,"Phoenix Suns",130,"Los Angeles Clippers",103,18495,0,-27,27,"2020-21",67.3913043478261
"6240",2021-07-01,"Atlanta Hawks",112,"Milwaukee Bucks",123,16389,1,11,11,"2020-21",76.5957446808511
"6241",2021-07-03,"Milwaukee Bucks",118,"Atlanta Hawks",107,16620,0,-11,11,"2020-21",65.9090909090909
"6242",2021-07-06,"Milwaukee Bucks",105,"Phoenix Suns",118,16557,1,13,13,"2020-21",74.468085106383
"6243",2021-07-08,"Milwaukee Bucks",108,"Phoenix Suns",118,16583,1,10,10,"2020-21",74.468085106383
"6244",2021-07-11,"Phoenix Suns",100,"Milwaukee Bucks",120,16637,1,20,20,"2020-21",76.5957446808511
"6245",2021-07-14,"Phoenix Suns",103,"Milwaukee Bucks",109,16911,1,6,6,"2020-21",76.5957446808511
"6246",2021-07-17,"Milwaukee Bucks",123,"Phoenix Suns",119,16562,0,-4,4,"2020-21",74.468085106383
"6247",2021-07-20,"Phoenix Suns",98,"Milwaukee Bucks",105,17397,1,7,7,"2020-21",76.5957446808511
